datetime,chainlink_social_volume_total,hyperliquid_social_volume_total,uniswap_social_volume_total,aave_social_volume_total,ondo-finance_social_volume_total,ethereum-classic_social_volume_total,ethena_social_volume_total,maker_social_volume_total,injective-protocol_social_volume_total,lido-dao_social_volume_total,raydium_social_volume_total,dexe_social_volume_total,pyth-network_social_volume_total,pendle_social_volume_total,aerodrome-finance_social_volume_total,thorchain_social_volume_total,telcoin_social_volume_total,dydx-chain_social_volume_total,morpho_social_volume_total,just_social_volume_total,sun-token_social_volume_total,olympus_social_volume_total,1inch_social_volume_total,frax_social_volume_total,convex-finance_social_volume_total,ether-fi_social_volume_total,0x_social_volume_total,solayer_social_volume_total,frax-share_social_volume_total,stargate-finance_social_volume_total,yearn-finance_social_volume_total,babylon_social_volume_total,solana-swap_social_volume_total,osmosis_social_volume_total,crvusd_social_volume_total,orca_social_volume_total,sushi_social_volume_total,cow-protocol_social_volume_total,cetus-protocol_social_volume_total,loopring_social_volume_total,lcx_social_volume_total,band-protocol_social_volume_total,zebec-network_social_volume_total,clearpool_social_volume_total,usual_social_volume_total,rocket-pool_social_volume_total,vvs-finance_social_volume_total,uma_social_volume_total,venus_social_volume_total,moonwell-artemis_social_volume_total,api3_social_volume_total,velo_social_volume_total,compound-ether_social_volume_total,spell-token_social_volume_total,orbs_social_volume_total,tellor_social_volume_total,marlin_social_volume_total,liquity_social_volume_total,pinlink_social_volume_total,numeraire_social_volume_total,bonfida_social_volume_total,ssv-network_social_volume_total,bancor_social_volume_total,balancer_social_volume_total,oraichain-token_social_volume_total,coin98_social_volume_total,dia-data_social_volume_total,tokenfi_social_volume_total,dodo_social_volume_total,magic-internet-money_social_volume_total,dydx_social_volume_total,kujira_social_volume_total,keep-network_social_volume_total,smardex_social_volume_total,messier_social_volume_total,hashflow_social_volume_total,renzo_social_volume_total,strike_social_volume_total,acala_social_volume_total,liquity-usd_social_volume_total,parcl_social_volume_total,ampleforth_social_volume_total,wrapped-nxm_social_volume_total,whiteheart_social_volume_total,minswap_social_volume_total,hegic_social_volume_total,insure_social_volume_total,derive_social_volume_total,suilend_social_volume_total,saucerswap_social_volume_total,tao-bot_social_volume_total,alpaca-finance_social_volume_total,bluefin_social_volume_total,compound-usd-coin_social_volume_total,paraswap_social_volume_total,orderly-network_social_volume_total,bella-protocol_social_volume_total,degate_social_volume_total,stafi_social_volume_total,unizen_social_volume_total,melon_social_volume_total,chainflip_social_volume_total,seth_social_volume_total,alchemix_social_volume_total,wanchain_social_volume_total,perpetual-protocol_social_volume_total,harvest-finance_social_volume_total,step-finance_social_volume_total,badger-dao_social_volume_total,stake-dao_social_volume_total,polkastarter_social_volume_total,synfutures_social_volume_total,lever_social_volume_total,mango-markets_social_volume_total,vertex-protocol_social_volume_total,adshares_social_volume_total,quickswap_social_volume_total,dolomite_social_volume_total,ramp_social_volume_total,inverse-finance_social_volume_total,beefy-finance_social_volume_total,tokemak_social_volume_total,ribbon-finance_social_volume_total,tranchess_social_volume_total,cryptex-finance_social_volume_total,odos_social_volume_total,kryll_social_volume_total,hatom_social_volume_total,ellipsis_social_volume_total,orion-protocol_social_volume_total,aura-finance_social_volume_total,hydranet_social_volume_total,evervalue-coin_social_volume_total,airswap_social_volume_total,trustswap_social_volume_total
2023-06-23 00:00:00+00:00,151.0,,54.0,2.0,,238.0,,30.0,38.0,8.0,7.0,0.0,,4.0,0.0,7.0,7.0,,,0.0,0.0,2.0,8.0,13.0,1.0,,3.0,,6.0,2.0,2.0,,,19.0,4.0,,8.0,10.0,,35.0,12.0,16.0,,0.0,,6.0,0.0,33.0,1.0,,2.0,62.0,0.0,19.0,0.0,1.0,3.0,2.0,,1.0,2.0,0.0,7.0,4.0,0.0,0.0,15.0,0.0,1.0,3.0,6.0,,22.0,0.0,1.0,2.0,0.0,33.0,0.0,5.0,,1.0,0.0,0.0,,0.0,1.0,,,,,3.0,,0.0,1.0,,2.0,1.0,2.0,0.0,5.0,43.0,4.0,1.0,14.0,10.0,24.0,0.0,1.0,1.0,0.0,,4.0,0.0,,29.0,161.0,,14.0,0.0,1.0,0.0,0.0,0.0,0.0,,0.0,,0.0,4.0,0.0,,,0.0,0.0
2023-06-24 00:00:00+00:00,85.0,,51.0,5.0,,254.0,,31.0,17.0,8.0,8.0,0.0,,3.0,0.0,6.0,11.0,,,1.0,0.0,1.0,2.0,15.0,1.0,,0.0,,4.0,0.0,1.0,,,8.0,2.0,,6.0,4.0,,44.0,10.0,12.0,,0.0,,12.0,0.0,13.0,2.0,,0.0,43.0,0.0,7.0,1.0,0.0,2.0,3.0,,1.0,0.0,0.0,4.0,0.0,1.0,1.0,13.0,0.0,0.0,3.0,8.0,,23.0,0.0,0.0,1.0,0.0,26.0,1.0,2.0,,11.0,0.0,0.0,,0.0,2.0,,,,,2.0,,0.0,0.0,,2.0,0.0,0.0,0.0,1.0,55.0,8.0,0.0,6.0,8.0,46.0,1.0,1.0,2.0,1.0,,1.0,0.0,,31.0,100.0,,9.0,0.0,0.0,3.0,0.0,0.0,0.0,,0.0,,0.0,0.0,5.0,,,0.0,0.0
2023-06-25 00:00:00+00:00,155.0,,61.0,30.0,,285.0,,21.0,47.0,4.0,6.0,0.0,,2.0,0.0,8.0,5.0,,,4.0,0.0,0.0,2.0,11.0,1.0,,3.0,,3.0,0.0,1.0,,,6.0,4.0,,8.0,5.0,,34.0,8.0,19.0,,0.0,,14.0,0.0,10.0,0.0,,1.0,53.0,1.0,12.0,0.0,0.0,5.0,5.0,,1.0,1.0,0.0,14.0,4.0,0.0,0.0,18.0,0.0,1.0,2.0,0.0,,22.0,1.0,0.0,1.0,0.0,40.0,4.0,0.0,,26.0,0.0,0.0,,0.0,0.0,,,,,0.0,,0.0,0.0,,0.0,0.0,1.0,0.0,3.0,23.0,5.0,3.0,5.0,3.0,47.0,1.0,0.0,0.0,0.0,,2.0,0.0,,44.0,108.0,,10.0,0.0,0.0,0.0,0.0,0.0,1.0,,0.0,,0.0,0.0,1.0,,,0.0,0.0
2023-06-26 00:00:00+00:00,179.0,,41.0,8.0,,242.0,,37.0,16.0,3.0,8.0,0.0,,4.0,0.0,17.0,3.0,,,3.0,0.0,10.0,6.0,21.0,4.0,,1.0,,11.0,1.0,0.0,,,17.0,26.0,,6.0,5.0,,38.0,9.0,9.0,,1.0,,18.0,0.0,28.0,0.0,,2.0,20.0,0.0,10.0,2.0,2.0,2.0,2.0,,0.0,0.0,0.0,5.0,3.0,0.0,2.0,27.0,0.0,0.0,10.0,9.0,,12.0,1.0,1.0,2.0,0.0,29.0,0.0,2.0,,13.0,0.0,0.0,,0.0,3.0,,,,,0.0,,0.0,0.0,,0.0,4.0,0.0,0.0,0.0,42.0,6.0,2.0,15.0,7.0,36.0,3.0,1.0,2.0,1.0,,2.0,0.0,,37.0,97.0,,15.0,0.0,1.0,1.0,0.0,0.0,0.0,,1.0,,6.0,0.0,0.0,,,0.0,0.0
2023-06-27 00:00:00+00:00,117.0,,46.0,11.0,,287.0,,35.0,9.0,6.0,11.0,0.0,,1.0,0.0,19.0,12.0,,,7.0,0.0,3.0,8.0,21.0,0.0,,4.0,,8.0,0.0,2.0,,,8.0,4.0,,5.0,3.0,,44.0,10.0,7.0,,0.0,,5.0,0.0,27.0,1.0,,2.0,1.0,0.0,9.0,0.0,1.0,5.0,3.0,,0.0,0.0,0.0,8.0,2.0,0.0,0.0,33.0,0.0,0.0,7.0,20.0,,29.0,0.0,0.0,0.0,0.0,32.0,4.0,0.0,,8.0,0.0,0.0,,0.0,4.0,,,,,0.0,,0.0,3.0,,0.0,1.0,0.0,0.0,4.0,39.0,0.0,0.0,22.0,6.0,33.0,1.0,1.0,1.0,2.0,,2.0,0.0,,46.0,113.0,,14.0,0.0,0.0,0.0,0.0,0.0,1.0,,0.0,,11.0,0.0,4.0,,,0.0,0.0
2023-06-28 00:00:00+00:00,112.0,,66.0,8.0,,251.0,,35.0,9.0,6.0,13.0,0.0,,5.0,0.0,12.0,3.0,,,9.0,1.0,2.0,3.0,23.0,6.0,,3.0,,9.0,0.0,2.0,,,8.0,11.0,,13.0,9.0,,33.0,24.0,13.0,,0.0,,10.0,0.0,32.0,0.0,,1.0,0.0,0.0,9.0,0.0,0.0,8.0,1.0,,0.0,1.0,1.0,1.0,4.0,1.0,0.0,29.0,0.0,0.0,6.0,18.0,,26.0,0.0,1.0,1.0,0.0,38.0,0.0,3.0,,9.0,0.0,0.0,,0.0,3.0,,,,,1.0,,0.0,0.0,,0.0,1.0,0.0,0.0,0.0,43.0,1.0,2.0,29.0,16.0,46.0,1.0,1.0,0.0,2.0,,2.0,0.0,,88.0,98.0,,14.0,0.0,2.0,0.0,0.0,0.0,0.0,,1.0,,3.0,0.0,2.0,,,1.0,0.0
2023-06-29 00:00:00+00:00,101.0,,68.0,9.0,,278.0,,37.0,10.0,3.0,10.0,2.0,,5.0,0.0,7.0,4.0,,,2.0,1.0,1.0,6.0,8.0,0.0,,2.0,,1.0,1.0,3.0,,,8.0,16.0,,1.0,10.0,,40.0,13.0,17.0,,0.0,,5.0,2.0,24.0,0.0,,2.0,2.0,0.0,7.0,0.0,0.0,10.0,0.0,,1.0,0.0,1.0,4.0,4.0,0.0,0.0,32.0,0.0,2.0,6.0,9.0,,24.0,2.0,0.0,0.0,2.0,30.0,1.0,3.0,,4.0,0.0,0.0,,0.0,3.0,,,,,4.0,,0.0,2.0,,2.0,0.0,0.0,0.0,0.0,37.0,6.0,3.0,13.0,6.0,38.0,1.0,0.0,1.0,0.0,,3.0,0.0,,43.0,106.0,,17.0,1.0,3.0,2.0,0.0,0.0,0.0,,0.0,,3.0,0.0,4.0,,,0.0,0.0
2023-06-30 00:00:00+00:00,95.0,,48.0,15.0,,308.0,,29.0,12.0,3.0,16.0,0.0,,7.0,0.0,11.0,2.0,,,2.0,0.0,3.0,4.0,12.0,0.0,,2.0,,2.0,0.0,2.0,,,3.0,0.0,,4.0,11.0,,53.0,4.0,23.0,,0.0,,1.0,1.0,29.0,1.0,,1.0,4.0,0.0,9.0,5.0,1.0,3.0,1.0,,0.0,0.0,0.0,1.0,0.0,0.0,0.0,24.0,0.0,0.0,4.0,7.0,,23.0,3.0,0.0,1.0,1.0,51.0,1.0,4.0,,3.0,0.0,0.0,,0.0,5.0,,,,,1.0,,0.0,0.0,,4.0,1.0,0.0,0.0,3.0,36.0,1.0,0.0,13.0,7.0,27.0,2.0,3.0,1.0,0.0,,3.0,0.0,,37.0,140.0,,14.0,0.0,0.0,2.0,0.0,0.0,0.0,,1.0,,2.0,4.0,4.0,,,0.0,0.0
2023-07-01 00:00:00+00:00,117.0,,45.0,7.0,,245.0,,21.0,9.0,4.0,10.0,0.0,,3.0,0.0,5.0,2.0,,,10.0,0.0,1.0,4.0,6.0,0.0,,0.0,,3.0,1.0,1.0,,,4.0,5.0,,0.0,6.0,,27.0,4.0,6.0,,0.0,,8.0,2.0,11.0,0.0,,0.0,1.0,0.0,11.0,0.0,0.0,1.0,1.0,,1.0,0.0,0.0,2.0,0.0,0.0,0.0,14.0,0.0,0.0,3.0,3.0,,16.0,0.0,0.0,0.0,1.0,38.0,1.0,0.0,,2.0,0.0,0.0,,0.0,2.0,,,,,0.0,,0.0,1.0,,1.0,0.0,0.0,0.0,0.0,25.0,4.0,0.0,11.0,0.0,30.0,1.0,0.0,1.0,0.0,,2.0,0.0,,39.0,92.0,,9.0,1.0,0.0,0.0,0.0,0.0,0.0,,0.0,,3.0,0.0,2.0,,,0.0,0.0
2023-07-02 00:00:00+00:00,83.0,,34.0,5.0,,222.0,,14.0,20.0,0.0,5.0,0.0,,3.0,0.0,24.0,2.0,,,7.0,0.0,1.0,1.0,10.0,1.0,,0.0,,3.0,0.0,2.0,,,9.0,4.0,,11.0,8.0,,28.0,1.0,4.0,,0.0,,7.0,0.0,13.0,0.0,,0.0,0.0,0.0,9.0,1.0,0.0,1.0,2.0,,1.0,0.0,0.0,10.0,1.0,0.0,0.0,23.0,0.0,0.0,2.0,7.0,,15.0,0.0,0.0,1.0,1.0,17.0,1.0,0.0,,3.0,0.0,0.0,,0.0,6.0,,,,,0.0,,0.0,0.0,,0.0,0.0,0.0,0.0,1.0,22.0,1.0,0.0,6.0,1.0,28.0,1.0,0.0,0.0,0.0,,1.0,0.0,,37.0,79.0,,9.0,1.0,0.0,0.0,0.0,0.0,2.0,,0.0,,2.0,0.0,2.0,,,0.0,0.0
2023-07-03 00:00:00+00:00,126.0,,46.0,9.0,,292.0,,33.0,16.0,4.0,3.0,0.0,,27.0,0.0,10.0,4.0,,,0.0,0.0,0.0,0.0,13.0,0.0,,0.0,,3.0,0.0,4.0,,,12.0,4.0,,0.0,4.0,,31.0,0.0,8.0,,0.0,,9.0,0.0,21.0,1.0,,1.0,0.0,0.0,11.0,0.0,0.0,0.0,2.0,,1.0,0.0,0.0,10.0,0.0,2.0,0.0,17.0,0.0,1.0,3.0,3.0,,21.0,0.0,1.0,1.0,0.0,28.0,2.0,0.0,,7.0,0.0,0.0,,0.0,2.0,,,,,3.0,,0.0,0.0,,1.0,0.0,0.0,0.0,1.0,31.0,0.0,0.0,9.0,2.0,26.0,0.0,1.0,2.0,0.0,,3.0,0.0,,29.0,89.0,,15.0,0.0,1.0,0.0,0.0,0.0,0.0,,0.0,,3.0,3.0,4.0,,,0.0,0.0
2023-07-04 00:00:00+00:00,107.0,,40.0,11.0,,248.0,,25.0,11.0,4.0,7.0,1.0,,15.0,0.0,16.0,0.0,,,0.0,0.0,1.0,3.0,12.0,5.0,,2.0,,4.0,0.0,5.0,,,11.0,16.0,,2.0,4.0,,55.0,0.0,13.0,,0.0,,21.0,1.0,18.0,0.0,,1.0,1.0,0.0,9.0,0.0,4.0,1.0,0.0,,0.0,0.0,0.0,4.0,1.0,0.0,0.0,46.0,0.0,1.0,4.0,11.0,,20.0,1.0,0.0,0.0,0.0,28.0,1.0,0.0,,9.0,0.0,0.0,,0.0,7.0,,,,,3.0,,0.0,0.0,,2.0,0.0,0.0,0.0,1.0,31.0,3.0,2.0,17.0,5.0,31.0,1.0,0.0,0.0,0.0,,0.0,0.0,,24.0,117.0,,14.0,1.0,0.0,0.0,0.0,0.0,0.0,,0.0,,0.0,0.0,2.0,,,0.0,1.0
2023-07-05 00:00:00+00:00,189.0,,45.0,19.0,,281.0,,34.0,13.0,3.0,5.0,7.0,,14.0,0.0,5.0,7.0,,,0.0,0.0,7.0,2.0,9.0,2.0,,2.0,,2.0,2.0,2.0,,,4.0,18.0,,1.0,4.0,,42.0,6.0,11.0,,0.0,,8.0,0.0,39.0,0.0,,3.0,1.0,0.0,8.0,0.0,1.0,5.0,1.0,,0.0,0.0,0.0,4.0,2.0,0.0,0.0,24.0,0.0,0.0,4.0,7.0,,31.0,0.0,1.0,0.0,0.0,22.0,2.0,0.0,,3.0,0.0,0.0,,0.0,2.0,,,,,5.0,,0.0,1.0,,0.0,1.0,4.0,0.0,4.0,27.0,3.0,4.0,18.0,3.0,32.0,1.0,1.0,0.0,5.0,,0.0,0.0,,36.0,98.0,,6.0,0.0,8.0,0.0,0.0,0.0,0.0,,0.0,,0.0,0.0,1.0,,,0.0,0.0
2023-07-06 00:00:00+00:00,147.0,,43.0,15.0,,279.0,,25.0,24.0,3.0,11.0,0.0,,9.0,0.0,10.0,6.0,,,0.0,0.0,1.0,5.0,31.0,6.0,,5.0,,31.0,2.0,5.0,,,6.0,7.0,,5.0,10.0,,25.0,3.0,19.0,,0.0,,3.0,0.0,23.0,1.0,,3.0,2.0,0.0,18.0,0.0,1.0,14.0,3.0,,0.0,1.0,1.0,6.0,1.0,0.0,0.0,25.0,0.0,1.0,9.0,5.0,,23.0,1.0,0.0,3.0,0.0,30.0,0.0,2.0,,4.0,0.0,0.0,,0.0,0.0,,,,,9.0,,0.0,4.0,,1.0,0.0,1.0,0.0,2.0,34.0,10.0,1.0,16.0,4.0,36.0,1.0,0.0,1.0,1.0,,2.0,1.0,,42.0,126.0,,13.0,0.0,0.0,0.0,0.0,0.0,0.0,,2.0,,1.0,0.0,1.0,,,0.0,1.0
2023-07-07 00:00:00+00:00,103.0,,37.0,7.0,,282.0,,23.0,12.0,9.0,10.0,0.0,,1.0,0.0,18.0,5.0,,,4.0,0.0,4.0,8.0,19.0,0.0,,0.0,,14.0,0.0,7.0,,,6.0,12.0,,2.0,8.0,,46.0,6.0,11.0,,0.0,,4.0,0.0,23.0,3.0,,0.0,1.0,0.0,17.0,0.0,0.0,9.0,0.0,,0.0,1.0,1.0,6.0,3.0,1.0,1.0,16.0,0.0,0.0,6.0,3.0,,17.0,0.0,0.0,0.0,0.0,18.0,1.0,4.0,,4.0,0.0,0.0,,1.0,3.0,,,,,1.0,,0.0,0.0,,13.0,4.0,1.0,2.0,3.0,24.0,1.0,1.0,34.0,3.0,61.0,0.0,1.0,2.0,0.0,,2.0,0.0,,30.0,109.0,,16.0,0.0,0.0,4.0,1.0,0.0,1.0,,0.0,,2.0,0.0,0.0,,,0.0,0.0
2023-07-08 00:00:00+00:00,211.0,,38.0,13.0,,280.0,,26.0,24.0,14.0,3.0,1.0,,7.0,0.0,12.0,4.0,,,0.0,0.0,1.0,1.0,22.0,4.0,,1.0,,6.0,0.0,2.0,,,16.0,8.0,,5.0,3.0,,47.0,5.0,9.0,,0.0,,3.0,0.0,19.0,1.0,,1.0,2.0,0.0,3.0,0.0,1.0,15.0,1.0,,0.0,0.0,0.0,1.0,1.0,2.0,1.0,33.0,0.0,0.0,5.0,6.0,,14.0,0.0,0.0,0.0,0.0,29.0,3.0,1.0,,4.0,0.0,0.0,,0.0,2.0,,,,,3.0,,0.0,0.0,,6.0,1.0,2.0,2.0,1.0,34.0,3.0,0.0,12.0,2.0,38.0,3.0,0.0,2.0,0.0,,1.0,0.0,,25.0,100.0,,13.0,0.0,0.0,0.0,0.0,0.0,0.0,,0.0,,0.0,0.0,2.0,,,0.0,0.0
2023-07-09 00:00:00+00:00,97.0,,22.0,2.0,,219.0,,21.0,30.0,13.0,2.0,0.0,,7.0,0.0,13.0,2.0,,,0.0,0.0,0.0,14.0,3.0,4.0,,1.0,,7.0,0.0,4.0,,,6.0,13.0,,2.0,3.0,,79.0,15.0,13.0,,0.0,,8.0,2.0,1.0,0.0,,2.0,1.0,0.0,5.0,0.0,0.0,16.0,0.0,,1.0,0.0,0.0,5.0,5.0,2.0,0.0,14.0,0.0,0.0,2.0,4.0,,14.0,0.0,0.0,1.0,0.0,13.0,4.0,0.0,,1.0,0.0,0.0,,0.0,4.0,,,,,8.0,,0.0,0.0,,9.0,0.0,0.0,4.0,0.0,45.0,2.0,0.0,14.0,2.0,18.0,1.0,0.0,2.0,1.0,,1.0,0.0,,11.0,61.0,,14.0,1.0,2.0,3.0,0.0,0.0,0.0,,0.0,,0.0,2.0,2.0,,,0.0,0.0
2023-07-10 00:00:00+00:00,75.0,,56.0,17.0,,233.0,,21.0,27.0,8.0,3.0,0.0,,6.0,0.0,17.0,13.0,,,1.0,0.0,0.0,1.0,19.0,1.0,,2.0,,2.0,8.0,5.0,,,4.0,15.0,,5.0,2.0,,52.0,6.0,13.0,,0.0,,26.0,0.0,7.0,4.0,,0.0,1.0,3.0,5.0,0.0,2.0,7.0,2.0,,1.0,0.0,0.0,5.0,0.0,1.0,0.0,16.0,0.0,2.0,0.0,4.0,,20.0,4.0,0.0,0.0,1.0,13.0,1.0,4.0,,4.0,0.0,0.0,,0.0,0.0,,,,,4.0,,0.0,1.0,,1.0,0.0,1.0,9.0,2.0,48.0,1.0,1.0,9.0,4.0,31.0,1.0,1.0,3.0,0.0,,8.0,0.0,,26.0,103.0,,10.0,4.0,2.0,2.0,0.0,0.0,0.0,,1.0,,1.0,0.0,1.0,,,1.0,2.0
2023-07-11 00:00:00+00:00,121.0,,46.0,24.0,,242.0,,26.0,33.0,7.0,6.0,1.0,,13.0,0.0,22.0,10.0,,,1.0,0.0,1.0,2.0,15.0,2.0,,1.0,,3.0,4.0,3.0,,,3.0,12.0,,2.0,1.0,,40.0,8.0,13.0,,0.0,,10.0,0.0,20.0,2.0,,3.0,2.0,0.0,4.0,0.0,0.0,13.0,3.0,,0.0,1.0,0.0,12.0,5.0,2.0,0.0,18.0,0.0,1.0,11.0,6.0,,18.0,0.0,0.0,0.0,0.0,30.0,9.0,0.0,,2.0,0.0,0.0,,0.0,0.0,,,,,3.0,,0.0,0.0,,0.0,1.0,0.0,6.0,5.0,35.0,0.0,1.0,14.0,5.0,32.0,0.0,3.0,1.0,1.0,,1.0,0.0,,21.0,122.0,,14.0,0.0,2.0,3.0,0.0,0.0,0.0,,0.0,,1.0,0.0,1.0,,,0.0,1.0
2023-07-12 00:00:00+00:00,146.0,,45.0,30.0,,325.0,,26.0,32.0,5.0,8.0,0.0,,4.0,0.0,23.0,11.0,,,1.0,0.0,1.0,12.0,11.0,5.0,,2.0,,3.0,1.0,2.0,,,1.0,6.0,,5.0,6.0,,40.0,9.0,17.0,,0.0,,6.0,0.0,34.0,1.0,,2.0,1.0,0.0,6.0,0.0,0.0,8.0,25.0,,1.0,3.0,0.0,1.0,3.0,4.0,2.0,51.0,0.0,0.0,3.0,3.0,,35.0,4.0,0.0,5.0,1.0,30.0,5.0,2.0,,8.0,0.0,0.0,,0.0,4.0,,,,,4.0,,0.0,0.0,,1.0,1.0,3.0,1.0,5.0,31.0,2.0,0.0,14.0,5.0,43.0,2.0,0.0,2.0,0.0,,0.0,0.0,,28.0,125.0,,16.0,0.0,0.0,0.0,7.0,1.0,0.0,,0.0,,3.0,0.0,1.0,,,0.0,0.0
2023-07-13 00:00:00+00:00,161.0,,77.0,21.0,,312.0,,44.0,40.0,3.0,12.0,0.0,,7.0,0.0,28.0,9.0,,,1.0,1.0,1.0,6.0,15.0,2.0,,2.0,,6.0,7.0,4.0,,,10.0,9.0,,7.0,14.0,,48.0,7.0,41.0,,1.0,,5.0,2.0,25.0,1.0,,3.0,2.0,0.0,15.0,0.0,2.0,7.0,32.0,,0.0,1.0,0.0,10.0,1.0,8.0,2.0,55.0,0.0,0.0,10.0,6.0,,20.0,9.0,0.0,1.0,2.0,57.0,1.0,2.0,,5.0,0.0,0.0,,0.0,1.0,,,,,5.0,,0.0,0.0,,1.0,5.0,1.0,3.0,8.0,89.0,0.0,1.0,15.0,1.0,55.0,0.0,2.0,1.0,1.0,,6.0,0.0,,55.0,142.0,,19.0,0.0,0.0,1.0,1.0,0.0,0.0,,1.0,,16.0,1.0,2.0,,,1.0,0.0
2023-07-14 00:00:00+00:00,208.0,,63.0,12.0,,315.0,,36.0,98.0,37.0,5.0,0.0,,11.0,0.0,17.0,25.0,,,0.0,1.0,6.0,2.0,14.0,4.0,,3.0,,5.0,3.0,6.0,,,7.0,9.0,,7.0,9.0,,27.0,3.0,28.0,,0.0,,5.0,2.0,30.0,5.0,,1.0,0.0,0.0,15.0,2.0,1.0,8.0,25.0,,0.0,1.0,0.0,3.0,4.0,2.0,0.0,27.0,0.0,2.0,4.0,2.0,,35.0,2.0,0.0,1.0,0.0,64.0,0.0,10.0,,5.0,0.0,0.0,,0.0,0.0,,,,,5.0,,0.0,1.0,,8.0,0.0,1.0,6.0,4.0,78.0,4.0,1.0,40.0,8.0,34.0,4.0,1.0,0.0,1.0,,5.0,0.0,,37.0,135.0,,11.0,4.0,0.0,0.0,1.0,0.0,0.0,,0.0,,18.0,1.0,2.0,,,0.0,0.0
2023-07-15 00:00:00+00:00,217.0,,31.0,20.0,,296.0,,35.0,55.0,20.0,13.0,0.0,,17.0,0.0,19.0,14.0,,,5.0,0.0,1.0,2.0,5.0,0.0,,2.0,,1.0,0.0,0.0,,,8.0,5.0,,5.0,9.0,,41.0,3.0,36.0,,0.0,,3.0,0.0,20.0,1.0,,1.0,2.0,0.0,7.0,0.0,0.0,8.0,9.0,,0.0,1.0,1.0,10.0,1.0,4.0,0.0,17.0,0.0,0.0,8.0,9.0,,19.0,2.0,1.0,1.0,0.0,43.0,3.0,1.0,,2.0,0.0,0.0,,1.0,1.0,,,,,0.0,,0.0,0.0,,0.0,1.0,2.0,1.0,1.0,29.0,1.0,0.0,10.0,7.0,41.0,1.0,1.0,2.0,1.0,,5.0,0.0,,30.0,93.0,,7.0,1.0,0.0,1.0,1.0,0.0,0.0,,0.0,,1.0,1.0,2.0,,,1.0,0.0
2023-07-16 00:00:00+00:00,170.0,,61.0,14.0,,280.0,,52.0,41.0,11.0,5.0,0.0,,6.0,0.0,16.0,28.0,,,1.0,0.0,0.0,23.0,13.0,1.0,,5.0,,3.0,1.0,2.0,,,14.0,9.0,,9.0,14.0,,29.0,18.0,24.0,,0.0,,5.0,0.0,17.0,3.0,,3.0,0.0,0.0,12.0,0.0,1.0,2.0,4.0,,0.0,1.0,0.0,1.0,0.0,1.0,1.0,28.0,0.0,1.0,14.0,0.0,,14.0,2.0,0.0,4.0,0.0,56.0,5.0,6.0,,2.0,0.0,0.0,,0.0,0.0,,,,,0.0,,0.0,3.0,,1.0,3.0,2.0,5.0,2.0,39.0,0.0,0.0,6.0,5.0,46.0,3.0,2.0,0.0,0.0,,2.0,0.0,,31.0,102.0,,10.0,0.0,0.0,0.0,0.0,0.0,1.0,,0.0,,13.0,1.0,2.0,,,0.0,0.0
2023-07-17 00:00:00+00:00,357.0,,74.0,50.0,,332.0,,51.0,44.0,16.0,9.0,0.0,,2.0,0.0,33.0,10.0,,,1.0,0.0,0.0,99.0,21.0,0.0,,30.0,,2.0,1.0,6.0,,,1.0,6.0,,46.0,15.0,,45.0,4.0,33.0,,1.0,,16.0,0.0,30.0,4.0,,1.0,7.0,0.0,14.0,0.0,0.0,12.0,6.0,,1.0,0.0,0.0,10.0,3.0,0.0,1.0,24.0,0.0,12.0,5.0,17.0,,16.0,1.0,0.0,2.0,0.0,51.0,5.0,26.0,,1.0,0.0,0.0,,0.0,1.0,,,,,4.0,,0.0,0.0,,10.0,1.0,0.0,3.0,4.0,53.0,0.0,0.0,22.0,9.0,50.0,3.0,1.0,0.0,1.0,,4.0,0.0,,46.0,117.0,,16.0,0.0,3.0,0.0,0.0,0.0,0.0,,0.0,,27.0,0.0,0.0,,,2.0,2.0
2023-07-18 00:00:00+00:00,352.0,,95.0,17.0,,387.0,,31.0,31.0,3.0,2.0,2.0,,5.0,0.0,31.0,10.0,,,0.0,0.0,3.0,43.0,17.0,2.0,,12.0,,4.0,0.0,7.0,,,11.0,1.0,,57.0,7.0,,59.0,5.0,17.0,,0.0,,11.0,1.0,30.0,5.0,,3.0,3.0,1.0,12.0,4.0,0.0,4.0,2.0,,0.0,0.0,0.0,9.0,3.0,1.0,0.0,11.0,0.0,0.0,12.0,3.0,,19.0,3.0,0.0,1.0,2.0,42.0,2.0,6.0,,5.0,0.0,0.0,,0.0,4.0,,,,,3.0,,0.0,2.0,,2.0,3.0,0.0,2.0,3.0,51.0,2.0,1.0,21.0,3.0,83.0,2.0,3.0,0.0,0.0,,0.0,0.0,,35.0,175.0,,28.0,2.0,5.0,0.0,2.0,0.0,0.0,,0.0,,2.0,0.0,1.0,,,2.0,0.0
2023-07-19 00:00:00+00:00,235.0,,76.0,19.0,,416.0,,53.0,31.0,13.0,18.0,0.0,,5.0,0.0,10.0,8.0,,,3.0,0.0,1.0,28.0,16.0,9.0,,11.0,,0.0,0.0,2.0,,,9.0,12.0,,55.0,10.0,,54.0,18.0,11.0,,2.0,,18.0,4.0,26.0,9.0,,0.0,5.0,0.0,12.0,5.0,0.0,15.0,3.0,,1.0,0.0,1.0,13.0,1.0,4.0,0.0,22.0,0.0,1.0,15.0,11.0,,28.0,4.0,2.0,1.0,0.0,34.0,2.0,2.0,,0.0,0.0,0.0,,0.0,2.0,,,,,3.0,,0.0,0.0,,1.0,5.0,0.0,5.0,4.0,53.0,2.0,2.0,22.0,5.0,128.0,1.0,6.0,5.0,0.0,,2.0,1.0,,44.0,202.0,,27.0,0.0,2.0,1.0,1.0,0.0,0.0,,0.0,,19.0,4.0,0.0,,,0.0,0.0
2023-07-20 00:00:00+00:00,432.0,,61.0,11.0,,416.0,,42.0,39.0,4.0,9.0,0.0,,3.0,0.0,13.0,5.0,,,2.0,1.0,1.0,6.0,12.0,4.0,,5.0,,4.0,0.0,1.0,,,4.0,11.0,,34.0,14.0,,97.0,8.0,49.0,,0.0,,6.0,0.0,31.0,4.0,,5.0,0.0,0.0,11.0,0.0,5.0,9.0,2.0,,1.0,2.0,0.0,29.0,3.0,0.0,0.0,39.0,0.0,0.0,6.0,6.0,,20.0,7.0,1.0,0.0,0.0,53.0,16.0,0.0,,2.0,0.0,0.0,,0.0,2.0,,,,,1.0,,0.0,0.0,,0.0,1.0,4.0,8.0,3.0,68.0,1.0,0.0,26.0,7.0,81.0,3.0,3.0,2.0,1.0,,4.0,0.0,,36.0,174.0,,27.0,1.0,1.0,0.0,0.0,0.0,0.0,,0.0,,11.0,0.0,2.0,,,0.0,0.0
2023-07-21 00:00:00+00:00,357.0,,70.0,8.0,,332.0,,60.0,38.0,3.0,24.0,0.0,,4.0,0.0,10.0,7.0,,,0.0,0.0,3.0,6.0,12.0,3.0,,2.0,,3.0,0.0,2.0,,,16.0,19.0,,25.0,9.0,,40.0,6.0,26.0,,0.0,,37.0,2.0,23.0,6.0,,5.0,0.0,0.0,14.0,0.0,0.0,19.0,5.0,,0.0,1.0,0.0,12.0,1.0,3.0,0.0,25.0,0.0,3.0,19.0,12.0,,26.0,1.0,0.0,1.0,0.0,29.0,14.0,1.0,,1.0,1.0,0.0,,0.0,4.0,,,,,1.0,,0.0,1.0,,1.0,0.0,1.0,6.0,3.0,51.0,1.0,3.0,9.0,3.0,69.0,0.0,1.0,2.0,0.0,,1.0,1.0,,116.0,165.0,,31.0,0.0,2.0,1.0,1.0,1.0,1.0,,0.0,,5.0,0.0,5.0,,,1.0,0.0
2023-07-22 00:00:00+00:00,225.0,,72.0,16.0,,355.0,,30.0,29.0,2.0,3.0,0.0,,4.0,0.0,4.0,6.0,,,2.0,0.0,3.0,7.0,10.0,2.0,,4.0,,1.0,1.0,3.0,,,9.0,14.0,,24.0,2.0,,40.0,4.0,12.0,,0.0,,11.0,3.0,30.0,2.0,,0.0,1.0,0.0,9.0,1.0,3.0,14.0,1.0,,0.0,0.0,1.0,10.0,2.0,1.0,0.0,17.0,0.0,1.0,9.0,0.0,,21.0,4.0,1.0,0.0,1.0,35.0,2.0,1.0,,0.0,0.0,0.0,,0.0,1.0,,,,,0.0,,0.0,2.0,,1.0,2.0,0.0,1.0,4.0,27.0,0.0,2.0,11.0,2.0,63.0,5.0,2.0,3.0,1.0,,0.0,0.0,,38.0,137.0,,14.0,0.0,0.0,1.0,0.0,0.0,2.0,,1.0,,2.0,0.0,1.0,,,0.0,0.0
2023-07-23 00:00:00+00:00,185.0,,62.0,10.0,,319.0,,34.0,21.0,6.0,6.0,0.0,,13.0,0.0,10.0,8.0,,,1.0,0.0,2.0,4.0,7.0,5.0,,2.0,,2.0,0.0,1.0,,,6.0,6.0,,27.0,9.0,,37.0,4.0,22.0,,1.0,,10.0,0.0,13.0,2.0,,1.0,2.0,0.0,10.0,1.0,0.0,7.0,2.0,,0.0,0.0,0.0,6.0,0.0,0.0,0.0,27.0,0.0,0.0,6.0,2.0,,19.0,3.0,0.0,0.0,0.0,24.0,2.0,1.0,,0.0,0.0,0.0,,0.0,2.0,,,,,0.0,,0.0,0.0,,1.0,1.0,0.0,1.0,4.0,35.0,3.0,1.0,7.0,1.0,67.0,3.0,0.0,5.0,0.0,,1.0,0.0,,38.0,131.0,,9.0,0.0,0.0,0.0,0.0,0.0,1.0,,0.0,,2.0,0.0,2.0,,,0.0,0.0
2023-07-24 00:00:00+00:00,193.0,,67.0,12.0,,320.0,,38.0,27.0,1.0,9.0,0.0,,2.0,0.0,12.0,7.0,,,2.0,0.0,2.0,4.0,19.0,9.0,,0.0,,6.0,2.0,4.0,,,4.0,4.0,,30.0,10.0,,46.0,10.0,16.0,,0.0,,5.0,0.0,17.0,2.0,,2.0,2.0,0.0,15.0,24.0,0.0,5.0,1.0,,13.0,0.0,0.0,15.0,5.0,1.0,0.0,15.0,0.0,0.0,7.0,6.0,,24.0,6.0,0.0,0.0,0.0,53.0,1.0,0.0,,0.0,0.0,0.0,,0.0,1.0,,,,,1.0,,0.0,0.0,,1.0,0.0,1.0,1.0,9.0,38.0,3.0,3.0,15.0,4.0,66.0,3.0,0.0,2.0,1.0,,0.0,0.0,,36.0,142.0,,16.0,0.0,0.0,0.0,0.0,1.0,0.0,,0.0,,5.0,0.0,0.0,,,0.0,0.0
2023-07-25 00:00:00+00:00,184.0,,66.0,5.0,,334.0,,52.0,20.0,9.0,8.0,0.0,,5.0,0.0,13.0,9.0,,,3.0,0.0,4.0,3.0,22.0,6.0,,1.0,,4.0,2.0,3.0,,,7.0,3.0,,34.0,16.0,,32.0,4.0,12.0,,0.0,,11.0,1.0,32.0,4.0,,0.0,2.0,0.0,8.0,10.0,0.0,14.0,4.0,,1.0,0.0,0.0,23.0,8.0,1.0,1.0,19.0,0.0,0.0,12.0,6.0,,12.0,2.0,0.0,0.0,0.0,41.0,11.0,2.0,,3.0,0.0,0.0,,0.0,0.0,,,,,3.0,,2.0,0.0,,0.0,3.0,0.0,7.0,5.0,44.0,2.0,0.0,27.0,4.0,69.0,4.0,1.0,2.0,0.0,,3.0,1.0,,21.0,175.0,,13.0,0.0,2.0,0.0,1.0,0.0,0.0,,0.0,,11.0,1.0,2.0,,,0.0,0.0
2023-07-26 00:00:00+00:00,151.0,,39.0,5.0,,288.0,,49.0,24.0,5.0,5.0,0.0,,5.0,0.0,27.0,13.0,,,0.0,0.0,2.0,8.0,10.0,11.0,,0.0,,7.0,0.0,2.0,,,13.0,2.0,,22.0,15.0,,58.0,1.0,20.0,,0.0,,8.0,0.0,28.0,4.0,,0.0,2.0,1.0,14.0,14.0,2.0,13.0,3.0,,2.0,0.0,1.0,14.0,10.0,2.0,1.0,22.0,0.0,0.0,14.0,1.0,,14.0,1.0,0.0,0.0,0.0,37.0,0.0,1.0,,3.0,0.0,0.0,,0.0,3.0,,,,,1.0,,0.0,0.0,,0.0,2.0,0.0,4.0,1.0,44.0,0.0,0.0,19.0,9.0,63.0,4.0,1.0,2.0,0.0,,1.0,0.0,,41.0,146.0,,26.0,0.0,3.0,2.0,1.0,0.0,0.0,,0.0,,7.0,0.0,1.0,,,2.0,0.0
2023-07-27 00:00:00+00:00,200.0,,68.0,20.0,,301.0,,58.0,27.0,4.0,5.0,0.0,,7.0,0.0,19.0,7.0,,,0.0,0.0,3.0,7.0,7.0,15.0,,1.0,,1.0,4.0,2.0,,,14.0,8.0,,25.0,8.0,,28.0,1.0,9.0,,1.0,,4.0,1.0,28.0,5.0,,0.0,3.0,0.0,9.0,9.0,3.0,7.0,5.0,,1.0,0.0,1.0,6.0,4.0,0.0,0.0,25.0,0.0,1.0,9.0,5.0,,23.0,4.0,0.0,0.0,0.0,43.0,2.0,1.0,,3.0,0.0,0.0,,1.0,3.0,,,,,1.0,,0.0,0.0,,4.0,3.0,0.0,4.0,6.0,35.0,0.0,0.0,19.0,1.0,56.0,1.0,1.0,2.0,0.0,,2.0,0.0,,47.0,142.0,,23.0,0.0,1.0,0.0,0.0,0.0,0.0,,0.0,,10.0,0.0,0.0,,,0.0,0.0
2023-07-28 00:00:00+00:00,197.0,,62.0,9.0,,337.0,,50.0,26.0,5.0,2.0,1.0,,8.0,0.0,20.0,3.0,,,2.0,0.0,5.0,5.0,11.0,12.0,,3.0,,7.0,1.0,3.0,,,8.0,12.0,,7.0,13.0,,24.0,0.0,17.0,,0.0,,5.0,1.0,44.0,5.0,,2.0,6.0,0.0,13.0,14.0,0.0,15.0,2.0,,0.0,0.0,0.0,3.0,3.0,1.0,0.0,22.0,0.0,0.0,8.0,3.0,,20.0,2.0,0.0,1.0,0.0,42.0,2.0,0.0,,1.0,0.0,0.0,,0.0,3.0,,,,,1.0,,0.0,3.0,,3.0,4.0,1.0,7.0,4.0,36.0,2.0,0.0,31.0,2.0,62.0,2.0,3.0,1.0,0.0,,7.0,0.0,,37.0,149.0,,20.0,0.0,0.0,2.0,1.0,0.0,0.0,,0.0,,10.0,0.0,2.0,,,2.0,0.0
2023-07-29 00:00:00+00:00,159.0,,65.0,9.0,,266.0,,46.0,10.0,4.0,3.0,3.0,,4.0,0.0,18.0,9.0,,,5.0,0.0,3.0,10.0,22.0,3.0,,1.0,,7.0,0.0,2.0,,,13.0,11.0,,13.0,10.0,,28.0,1.0,8.0,,0.0,,3.0,0.0,32.0,7.0,,1.0,0.0,0.0,6.0,6.0,2.0,17.0,1.0,,3.0,0.0,1.0,5.0,2.0,2.0,0.0,13.0,0.0,0.0,7.0,8.0,,22.0,1.0,0.0,2.0,0.0,29.0,2.0,1.0,,5.0,0.0,0.0,,0.0,0.0,,,,,1.0,,0.0,0.0,,3.0,1.0,0.0,3.0,2.0,30.0,1.0,0.0,10.0,1.0,73.0,1.0,1.0,1.0,0.0,,0.0,0.0,,32.0,125.0,,14.0,1.0,0.0,1.0,0.0,0.0,1.0,,0.0,,1.0,1.0,4.0,,,0.0,0.0
2023-07-30 00:00:00+00:00,143.0,,55.0,24.0,,269.0,,46.0,9.0,5.0,4.0,0.0,,4.0,1.0,9.0,6.0,,,1.0,0.0,1.0,4.0,33.0,12.0,,1.0,,10.0,1.0,1.0,,,5.0,13.0,,12.0,7.0,,22.0,2.0,9.0,,0.0,,13.0,0.0,13.0,2.0,,0.0,3.0,0.0,11.0,3.0,1.0,3.0,3.0,,0.0,0.0,0.0,4.0,6.0,2.0,1.0,15.0,0.0,0.0,9.0,9.0,,13.0,6.0,0.0,1.0,0.0,28.0,1.0,2.0,,1.0,0.0,0.0,,0.0,2.0,,,,,0.0,,0.0,2.0,,0.0,1.0,0.0,2.0,3.0,19.0,3.0,16.0,9.0,1.0,61.0,0.0,0.0,2.0,0.0,,4.0,0.0,,36.0,135.0,,28.0,0.0,0.0,0.0,0.0,0.0,2.0,,0.0,,4.0,1.0,1.0,,,1.0,0.0
2023-07-31 00:00:00+00:00,194.0,,63.0,60.0,,332.0,,55.0,21.0,11.0,3.0,0.0,,4.0,0.0,11.0,3.0,,,0.0,0.0,3.0,5.0,46.0,11.0,,3.0,,5.0,2.0,3.0,,,3.0,34.0,,19.0,5.0,,87.0,0.0,17.0,,2.0,,2.0,0.0,24.0,2.0,,0.0,7.0,0.0,14.0,3.0,1.0,12.0,3.0,,0.0,0.0,1.0,6.0,3.0,2.0,0.0,18.0,0.0,0.0,3.0,9.0,,25.0,3.0,1.0,1.0,0.0,25.0,7.0,2.0,,4.0,1.0,0.0,,0.0,1.0,,,,,2.0,,0.0,1.0,,2.0,2.0,0.0,2.0,5.0,50.0,2.0,19.0,16.0,6.0,49.0,2.0,0.0,1.0,0.0,,4.0,0.0,,38.0,142.0,,15.0,0.0,0.0,1.0,1.0,0.0,0.0,,1.0,,7.0,0.0,7.0,,,2.0,0.0
2023-08-01 00:00:00+00:00,138.0,,73.0,85.0,,312.0,,65.0,11.0,6.0,4.0,0.0,,5.0,0.0,5.0,5.0,,,1.0,0.0,2.0,9.0,125.0,14.0,,4.0,,35.0,8.0,2.0,,,6.0,22.0,,18.0,9.0,,166.0,7.0,13.0,,1.0,,9.0,0.0,23.0,2.0,,1.0,2.0,0.0,11.0,3.0,0.0,6.0,3.0,,0.0,0.0,0.0,5.0,7.0,1.0,0.0,33.0,0.0,1.0,11.0,17.0,,20.0,2.0,0.0,3.0,0.0,34.0,1.0,0.0,,2.0,0.0,0.0,,0.0,2.0,,,,,11.0,,0.0,1.0,,3.0,1.0,2.0,3.0,6.0,46.0,1.0,1.0,20.0,4.0,59.0,3.0,5.0,1.0,0.0,,0.0,0.0,,30.0,134.0,,19.0,3.0,0.0,0.0,0.0,0.0,0.0,,0.0,,14.0,2.0,1.0,,,3.0,0.0
2023-08-02 00:00:00+00:00,103.0,,150.0,28.0,,317.0,,49.0,17.0,3.0,5.0,0.0,,2.0,0.0,9.0,13.0,,,0.0,0.0,2.0,9.0,44.0,6.0,,4.0,,29.0,4.0,2.0,,,8.0,7.0,,20.0,11.0,,47.0,3.0,14.0,,1.0,,2.0,0.0,28.0,5.0,,0.0,1.0,1.0,11.0,4.0,0.0,12.0,3.0,,2.0,0.0,2.0,16.0,10.0,1.0,2.0,28.0,0.0,0.0,21.0,6.0,,19.0,5.0,0.0,1.0,0.0,36.0,3.0,1.0,,2.0,1.0,0.0,,0.0,2.0,,,,,1.0,,0.0,0.0,,0.0,1.0,1.0,12.0,1.0,39.0,3.0,1.0,29.0,8.0,72.0,0.0,3.0,3.0,0.0,,5.0,1.0,,32.0,139.0,,8.0,0.0,1.0,0.0,0.0,0.0,0.0,,0.0,,12.0,0.0,1.0,,,2.0,0.0
2023-08-03 00:00:00+00:00,159.0,,82.0,42.0,,303.0,,54.0,19.0,7.0,8.0,0.0,,3.0,0.0,20.0,16.0,,,0.0,0.0,1.0,7.0,27.0,4.0,,2.0,,7.0,3.0,2.0,,,18.0,13.0,,26.0,7.0,,48.0,3.0,11.0,,0.0,,7.0,1.0,26.0,6.0,,0.0,3.0,0.0,17.0,4.0,0.0,5.0,0.0,,0.0,0.0,0.0,9.0,3.0,0.0,5.0,16.0,0.0,1.0,10.0,8.0,,20.0,8.0,2.0,1.0,0.0,37.0,2.0,0.0,,6.0,0.0,0.0,,0.0,4.0,,,,,1.0,,0.0,0.0,,2.0,0.0,0.0,1.0,5.0,35.0,3.0,6.0,31.0,9.0,71.0,4.0,2.0,0.0,0.0,,0.0,0.0,,57.0,145.0,,6.0,4.0,0.0,1.0,0.0,0.0,0.0,,0.0,,22.0,0.0,1.0,,,0.0,0.0
2023-08-04 00:00:00+00:00,216.0,,50.0,20.0,,284.0,,40.0,26.0,8.0,1.0,0.0,,7.0,0.0,23.0,7.0,,,1.0,0.0,4.0,3.0,38.0,12.0,,5.0,,16.0,9.0,6.0,,,8.0,5.0,,11.0,15.0,,55.0,10.0,13.0,,1.0,,3.0,2.0,38.0,3.0,,1.0,2.0,0.0,11.0,6.0,0.0,15.0,5.0,,0.0,0.0,0.0,31.0,4.0,2.0,2.0,12.0,0.0,1.0,4.0,2.0,,24.0,4.0,0.0,2.0,1.0,36.0,1.0,1.0,,2.0,0.0,0.0,,1.0,3.0,,,,,1.0,,0.0,0.0,,0.0,1.0,0.0,1.0,0.0,35.0,0.0,29.0,18.0,10.0,83.0,5.0,0.0,1.0,0.0,,2.0,0.0,,69.0,138.0,,13.0,1.0,0.0,0.0,1.0,0.0,0.0,,0.0,,11.0,0.0,0.0,,,0.0,0.0
2023-08-05 00:00:00+00:00,290.0,,49.0,14.0,,263.0,,26.0,24.0,5.0,3.0,0.0,,2.0,0.0,9.0,4.0,,,2.0,0.0,0.0,2.0,16.0,4.0,,2.0,,15.0,5.0,4.0,,,23.0,4.0,,16.0,6.0,,21.0,0.0,15.0,,0.0,,1.0,0.0,14.0,1.0,,0.0,1.0,0.0,9.0,1.0,0.0,3.0,1.0,,0.0,1.0,0.0,45.0,6.0,2.0,1.0,16.0,0.0,1.0,5.0,9.0,,35.0,4.0,0.0,0.0,3.0,19.0,3.0,1.0,,2.0,0.0,0.0,,0.0,1.0,,,,,4.0,,0.0,0.0,,0.0,1.0,0.0,1.0,1.0,28.0,1.0,20.0,18.0,7.0,51.0,2.0,1.0,0.0,0.0,,2.0,0.0,,31.0,113.0,,13.0,1.0,0.0,0.0,0.0,0.0,0.0,,0.0,,2.0,1.0,2.0,,,1.0,0.0
2023-08-06 00:00:00+00:00,390.0,,49.0,5.0,,345.0,,36.0,19.0,3.0,2.0,0.0,,1.0,1.0,11.0,4.0,,,0.0,0.0,1.0,4.0,10.0,1.0,,0.0,,15.0,1.0,1.0,,,14.0,8.0,,13.0,13.0,,20.0,0.0,12.0,,0.0,,3.0,1.0,13.0,1.0,,29.0,0.0,0.0,7.0,1.0,1.0,4.0,0.0,,0.0,1.0,0.0,80.0,4.0,4.0,0.0,30.0,0.0,2.0,4.0,4.0,,64.0,2.0,0.0,0.0,0.0,36.0,2.0,0.0,,0.0,3.0,0.0,,0.0,2.0,,,,,1.0,,0.0,0.0,,2.0,0.0,1.0,2.0,3.0,34.0,0.0,17.0,15.0,8.0,49.0,1.0,3.0,3.0,0.0,,3.0,0.0,,47.0,111.0,,6.0,1.0,0.0,1.0,1.0,0.0,0.0,,0.0,,1.0,2.0,2.0,,,0.0,0.0
2023-08-07 00:00:00+00:00,261.0,,65.0,7.0,,360.0,,63.0,26.0,14.0,6.0,0.0,,3.0,0.0,4.0,5.0,,,2.0,0.0,4.0,5.0,30.0,4.0,,1.0,,11.0,6.0,2.0,,,15.0,6.0,,25.0,7.0,,37.0,2.0,26.0,,0.0,,15.0,0.0,30.0,2.0,,26.0,3.0,0.0,11.0,15.0,2.0,22.0,2.0,,0.0,0.0,0.0,21.0,5.0,2.0,12.0,38.0,0.0,14.0,6.0,7.0,,51.0,2.0,1.0,3.0,1.0,47.0,1.0,1.0,,1.0,0.0,0.0,,0.0,3.0,,,,,0.0,,0.0,0.0,,0.0,2.0,0.0,2.0,7.0,49.0,1.0,8.0,10.0,5.0,78.0,2.0,0.0,1.0,0.0,,4.0,1.0,,32.0,119.0,,19.0,0.0,0.0,0.0,0.0,0.0,0.0,,0.0,,10.0,0.0,1.0,,,2.0,0.0
2023-08-08 00:00:00+00:00,156.0,,96.0,14.0,,327.0,,47.0,27.0,4.0,7.0,1.0,,5.0,0.0,19.0,10.0,,,0.0,0.0,2.0,2.0,36.0,4.0,,1.0,,6.0,0.0,4.0,,,5.0,8.0,,26.0,12.0,,52.0,3.0,12.0,,0.0,,22.0,0.0,29.0,1.0,,6.0,6.0,0.0,3.0,1.0,0.0,7.0,0.0,,1.0,0.0,1.0,30.0,5.0,1.0,33.0,48.0,0.0,53.0,8.0,9.0,,24.0,0.0,0.0,3.0,0.0,43.0,1.0,3.0,,5.0,0.0,0.0,,0.0,3.0,,,,,2.0,,0.0,1.0,,2.0,1.0,2.0,3.0,5.0,48.0,0.0,2.0,18.0,4.0,56.0,2.0,1.0,0.0,0.0,,3.0,1.0,,26.0,162.0,,44.0,0.0,0.0,0.0,0.0,0.0,0.0,,0.0,,8.0,0.0,4.0,,,0.0,0.0
2023-08-09 00:00:00+00:00,186.0,,79.0,9.0,,344.0,,48.0,23.0,4.0,9.0,0.0,,3.0,0.0,26.0,4.0,,,0.0,0.0,1.0,7.0,18.0,3.0,,2.0,,8.0,1.0,1.0,,,9.0,1.0,,33.0,14.0,,50.0,2.0,24.0,,0.0,,22.0,0.0,40.0,1.0,,4.0,1.0,0.0,5.0,4.0,1.0,17.0,2.0,,0.0,1.0,0.0,19.0,3.0,1.0,43.0,26.0,0.0,9.0,19.0,4.0,,24.0,3.0,0.0,2.0,1.0,28.0,0.0,3.0,,3.0,2.0,0.0,,0.0,2.0,,,,,0.0,,0.0,0.0,,0.0,3.0,2.0,1.0,7.0,62.0,5.0,2.0,30.0,4.0,78.0,3.0,1.0,1.0,0.0,,2.0,0.0,,38.0,151.0,,26.0,0.0,3.0,3.0,0.0,0.0,0.0,,0.0,,10.0,2.0,4.0,,,0.0,0.0
2023-08-10 00:00:00+00:00,193.0,,66.0,14.0,,397.0,,60.0,24.0,1.0,15.0,0.0,,4.0,0.0,53.0,3.0,,,0.0,0.0,3.0,12.0,29.0,3.0,,3.0,,11.0,30.0,2.0,,,4.0,2.0,,33.0,14.0,,63.0,7.0,19.0,,1.0,,35.0,0.0,32.0,2.0,,0.0,0.0,0.0,19.0,4.0,0.0,9.0,3.0,,0.0,0.0,0.0,35.0,3.0,1.0,10.0,33.0,0.0,5.0,15.0,12.0,,21.0,3.0,6.0,8.0,0.0,25.0,0.0,2.0,,8.0,0.0,0.0,,0.0,3.0,,,,,1.0,,0.0,1.0,,2.0,4.0,1.0,3.0,3.0,44.0,3.0,1.0,6.0,6.0,145.0,3.0,0.0,1.0,1.0,,3.0,0.0,,48.0,164.0,,22.0,0.0,0.0,1.0,0.0,0.0,0.0,,0.0,,8.0,1.0,4.0,,,2.0,0.0
2023-08-11 00:00:00+00:00,268.0,,64.0,16.0,,373.0,,42.0,18.0,4.0,5.0,0.0,,1.0,0.0,63.0,10.0,,,1.0,1.0,2.0,7.0,32.0,3.0,,1.0,,12.0,4.0,1.0,,,7.0,3.0,,32.0,11.0,,24.0,4.0,7.0,,0.0,,9.0,0.0,33.0,4.0,,10.0,3.0,0.0,5.0,4.0,0.0,19.0,1.0,,0.0,0.0,2.0,25.0,0.0,4.0,33.0,25.0,0.0,5.0,8.0,8.0,,25.0,3.0,3.0,2.0,1.0,27.0,5.0,0.0,,1.0,1.0,0.0,,0.0,2.0,,,,,0.0,,0.0,0.0,,2.0,3.0,2.0,0.0,2.0,58.0,0.0,1.0,12.0,9.0,76.0,2.0,0.0,0.0,3.0,,3.0,0.0,,42.0,180.0,,24.0,2.0,0.0,2.0,3.0,0.0,0.0,,0.0,,11.0,0.0,5.0,,,1.0,1.0
2023-08-12 00:00:00+00:00,174.0,,126.0,20.0,,288.0,,35.0,18.0,5.0,7.0,0.0,,2.0,0.0,75.0,8.0,,,0.0,0.0,3.0,5.0,19.0,5.0,,2.0,,13.0,0.0,2.0,,,11.0,7.0,,27.0,10.0,,57.0,11.0,23.0,,0.0,,14.0,0.0,19.0,2.0,,11.0,3.0,0.0,17.0,2.0,0.0,12.0,1.0,,0.0,0.0,0.0,9.0,0.0,2.0,32.0,23.0,0.0,1.0,7.0,4.0,,21.0,8.0,0.0,1.0,0.0,38.0,4.0,2.0,,0.0,0.0,0.0,,0.0,2.0,,,,,0.0,,0.0,0.0,,3.0,1.0,0.0,4.0,1.0,44.0,2.0,0.0,30.0,4.0,115.0,0.0,1.0,1.0,1.0,,4.0,0.0,,27.0,117.0,,19.0,0.0,0.0,0.0,2.0,0.0,0.0,,0.0,,1.0,1.0,0.0,,,0.0,1.0
2023-08-13 00:00:00+00:00,157.0,,93.0,8.0,,308.0,,47.0,12.0,2.0,3.0,0.0,,4.0,0.0,127.0,6.0,,,1.0,1.0,3.0,5.0,11.0,4.0,,1.0,,1.0,1.0,1.0,,,4.0,8.0,,22.0,7.0,,62.0,23.0,22.0,,0.0,,8.0,0.0,27.0,2.0,,12.0,6.0,0.0,9.0,0.0,6.0,10.0,1.0,,0.0,0.0,0.0,24.0,1.0,2.0,25.0,17.0,0.0,11.0,5.0,13.0,,18.0,7.0,0.0,2.0,4.0,41.0,1.0,0.0,,2.0,0.0,0.0,,0.0,2.0,,,,,1.0,,0.0,1.0,,3.0,1.0,0.0,1.0,2.0,43.0,7.0,0.0,9.0,3.0,81.0,0.0,0.0,2.0,0.0,,6.0,0.0,,27.0,129.0,,34.0,0.0,2.0,1.0,0.0,0.0,0.0,,0.0,,2.0,0.0,3.0,,,1.0,1.0
2023-08-14 00:00:00+00:00,184.0,,90.0,11.0,,391.0,,57.0,25.0,5.0,3.0,0.0,,3.0,0.0,111.0,8.0,,,2.0,0.0,5.0,2.0,37.0,9.0,,0.0,,13.0,2.0,2.0,,,4.0,10.0,,44.0,8.0,,37.0,1.0,18.0,,1.0,,4.0,0.0,22.0,5.0,,3.0,0.0,0.0,14.0,11.0,7.0,10.0,5.0,,0.0,0.0,0.0,11.0,3.0,4.0,14.0,15.0,0.0,17.0,8.0,7.0,,19.0,4.0,2.0,0.0,2.0,54.0,1.0,7.0,,11.0,0.0,0.0,,0.0,4.0,,,,,1.0,,0.0,0.0,,2.0,3.0,1.0,3.0,3.0,47.0,2.0,0.0,15.0,16.0,113.0,1.0,13.0,3.0,2.0,,9.0,0.0,,45.0,181.0,,32.0,1.0,1.0,0.0,3.0,0.0,0.0,,0.0,,3.0,1.0,4.0,,,2.0,0.0
2023-08-15 00:00:00+00:00,173.0,,63.0,4.0,,354.0,,35.0,43.0,4.0,4.0,0.0,,7.0,0.0,149.0,3.0,,,1.0,1.0,2.0,12.0,26.0,14.0,,0.0,,11.0,0.0,7.0,,,31.0,16.0,,25.0,24.0,,47.0,4.0,25.0,,0.0,,18.0,0.0,29.0,4.0,,3.0,1.0,0.0,16.0,3.0,0.0,25.0,5.0,,0.0,1.0,2.0,9.0,2.0,3.0,3.0,25.0,0.0,1.0,14.0,5.0,,23.0,4.0,0.0,5.0,2.0,45.0,0.0,2.0,,3.0,0.0,0.0,,0.0,1.0,,,,,3.0,,0.0,1.0,,0.0,2.0,0.0,2.0,0.0,68.0,1.0,0.0,17.0,8.0,91.0,4.0,10.0,1.0,1.0,,6.0,0.0,,47.0,171.0,,20.0,1.0,0.0,0.0,2.0,0.0,0.0,,0.0,,5.0,4.0,2.0,,,0.0,0.0
2023-08-16 00:00:00+00:00,168.0,,88.0,16.0,,364.0,,56.0,59.0,5.0,5.0,0.0,,5.0,0.0,102.0,5.0,,,1.0,0.0,1.0,9.0,10.0,5.0,,8.0,,10.0,2.0,1.0,,,7.0,18.0,,12.0,11.0,,89.0,5.0,23.0,,2.0,,6.0,0.0,32.0,1.0,,5.0,1.0,0.0,15.0,0.0,4.0,10.0,4.0,,1.0,0.0,0.0,30.0,4.0,0.0,2.0,26.0,0.0,2.0,10.0,9.0,,30.0,2.0,1.0,3.0,2.0,35.0,2.0,0.0,,1.0,0.0,0.0,,0.0,4.0,,,,,1.0,,0.0,1.0,1.0,0.0,1.0,1.0,2.0,9.0,56.0,2.0,0.0,19.0,15.0,103.0,1.0,7.0,0.0,0.0,,12.0,0.0,,65.0,172.0,,29.0,1.0,1.0,1.0,3.0,0.0,1.0,,0.0,,10.0,3.0,2.0,,,0.0,1.0
2023-08-17 00:00:00+00:00,205.0,,70.0,28.0,,355.0,,40.0,80.0,7.0,10.0,0.0,,7.0,0.0,67.0,7.0,,,1.0,0.0,2.0,8.0,29.0,5.0,,10.0,,17.0,5.0,0.0,,,30.0,43.0,,57.0,7.0,,94.0,5.0,35.0,,1.0,,18.0,0.0,24.0,1.0,,2.0,4.0,1.0,21.0,1.0,1.0,9.0,3.0,,1.0,0.0,0.0,25.0,3.0,2.0,2.0,27.0,0.0,0.0,7.0,8.0,,26.0,3.0,1.0,2.0,4.0,35.0,1.0,1.0,,4.0,0.0,0.0,,0.0,0.0,,,,,0.0,,0.0,0.0,3.0,0.0,1.0,1.0,0.0,2.0,53.0,2.0,0.0,17.0,8.0,73.0,2.0,1.0,4.0,0.0,,3.0,0.0,,31.0,182.0,,24.0,2.0,0.0,3.0,0.0,0.0,0.0,,0.0,,7.0,1.0,0.0,,,0.0,0.0
2023-08-18 00:00:00+00:00,183.0,,57.0,11.0,,305.0,,52.0,124.0,6.0,16.0,2.0,,0.0,0.0,35.0,6.0,,,1.0,0.0,1.0,1.0,24.0,0.0,,3.0,,5.0,2.0,3.0,,,13.0,49.0,,20.0,11.0,,69.0,6.0,17.0,,0.0,,8.0,0.0,32.0,3.0,,1.0,0.0,0.0,8.0,0.0,0.0,13.0,2.0,,0.0,0.0,0.0,6.0,6.0,2.0,2.0,29.0,0.0,6.0,9.0,4.0,,15.0,1.0,3.0,0.0,1.0,64.0,0.0,0.0,,3.0,0.0,0.0,,0.0,6.0,,,,,0.0,,0.0,0.0,1.0,1.0,1.0,2.0,2.0,5.0,60.0,10.0,0.0,16.0,8.0,67.0,0.0,2.0,3.0,0.0,,5.0,0.0,,30.0,184.0,,23.0,2.0,0.0,0.0,0.0,0.0,0.0,,0.0,,8.0,1.0,2.0,,,0.0,1.0
2023-08-19 00:00:00+00:00,212.0,,68.0,12.0,,320.0,,33.0,76.0,6.0,9.0,2.0,,4.0,0.0,93.0,10.0,,,0.0,0.0,0.0,1.0,11.0,0.0,,0.0,,3.0,1.0,4.0,,,7.0,17.0,,15.0,14.0,,36.0,3.0,12.0,,1.0,,8.0,0.0,17.0,2.0,,2.0,5.0,0.0,13.0,2.0,1.0,9.0,3.0,,0.0,0.0,1.0,12.0,2.0,2.0,6.0,23.0,0.0,0.0,12.0,9.0,,20.0,0.0,1.0,1.0,1.0,35.0,2.0,1.0,,1.0,0.0,0.0,,1.0,1.0,,,,,3.0,,0.0,0.0,1.0,0.0,0.0,2.0,3.0,2.0,46.0,3.0,0.0,8.0,6.0,93.0,0.0,2.0,2.0,0.0,,0.0,1.0,,45.0,166.0,,22.0,0.0,0.0,1.0,0.0,0.0,2.0,,0.0,,5.0,0.0,0.0,,,0.0,1.0
2023-08-20 00:00:00+00:00,172.0,,125.0,15.0,,344.0,,31.0,67.0,11.0,10.0,0.0,,4.0,0.0,132.0,5.0,,,0.0,0.0,1.0,25.0,12.0,2.0,,3.0,,1.0,1.0,0.0,,,9.0,6.0,,25.0,7.0,,25.0,4.0,19.0,,0.0,,8.0,0.0,35.0,4.0,,1.0,5.0,0.0,11.0,0.0,0.0,5.0,1.0,,0.0,0.0,0.0,15.0,2.0,0.0,2.0,16.0,0.0,2.0,3.0,9.0,,20.0,0.0,0.0,1.0,1.0,21.0,0.0,0.0,,4.0,0.0,0.0,,0.0,3.0,,,,,2.0,,0.0,0.0,2.0,1.0,2.0,0.0,3.0,8.0,37.0,4.0,1.0,8.0,3.0,112.0,0.0,2.0,1.0,0.0,,8.0,0.0,,38.0,148.0,,11.0,2.0,0.0,1.0,1.0,0.0,0.0,,0.0,,3.0,0.0,0.0,,,1.0,0.0
2023-08-21 00:00:00+00:00,116.0,,102.0,9.0,,392.0,,39.0,61.0,14.0,14.0,1.0,,6.0,1.0,127.0,11.0,,,2.0,1.0,5.0,8.0,22.0,8.0,,2.0,,9.0,1.0,7.0,,,7.0,4.0,,6.0,12.0,,47.0,7.0,22.0,,1.0,,7.0,0.0,25.0,0.0,,1.0,3.0,0.0,7.0,1.0,2.0,10.0,2.0,,0.0,0.0,0.0,9.0,3.0,1.0,0.0,35.0,0.0,0.0,12.0,1.0,,22.0,1.0,0.0,1.0,1.0,30.0,3.0,2.0,,3.0,0.0,0.0,,0.0,1.0,,,,,1.0,,0.0,1.0,1.0,1.0,1.0,0.0,4.0,9.0,56.0,1.0,3.0,17.0,5.0,143.0,3.0,4.0,0.0,1.0,,2.0,0.0,,46.0,176.0,,28.0,5.0,0.0,2.0,0.0,0.0,0.0,,0.0,,8.0,0.0,3.0,,,1.0,1.0
2023-08-22 00:00:00+00:00,259.0,,79.0,13.0,,407.0,,53.0,67.0,7.0,18.0,1.0,,3.0,0.0,83.0,6.0,,,2.0,0.0,1.0,5.0,38.0,4.0,,2.0,,5.0,4.0,6.0,,,20.0,10.0,,19.0,6.0,,63.0,4.0,20.0,,0.0,,10.0,0.0,54.0,4.0,,1.0,3.0,0.0,13.0,0.0,1.0,14.0,1.0,,1.0,0.0,0.0,22.0,87.0,4.0,13.0,37.0,0.0,3.0,7.0,11.0,,36.0,3.0,0.0,0.0,0.0,41.0,3.0,2.0,,6.0,0.0,0.0,,0.0,4.0,,,,,1.0,,0.0,5.0,2.0,2.0,4.0,3.0,4.0,12.0,46.0,1.0,0.0,11.0,3.0,129.0,1.0,3.0,1.0,0.0,,28.0,0.0,,89.0,194.0,,34.0,6.0,0.0,0.0,4.0,0.0,0.0,,0.0,,10.0,2.0,6.0,,,1.0,0.0
2023-08-23 00:00:00+00:00,184.0,,75.0,10.0,,381.0,,52.0,71.0,13.0,10.0,0.0,,46.0,0.0,116.0,10.0,,,1.0,0.0,3.0,5.0,36.0,5.0,,1.0,,5.0,3.0,0.0,,,11.0,11.0,,21.0,14.0,,76.0,6.0,29.0,,0.0,,5.0,0.0,41.0,1.0,,9.0,2.0,0.0,24.0,2.0,0.0,10.0,3.0,,2.0,0.0,0.0,7.0,27.0,4.0,3.0,32.0,0.0,3.0,7.0,15.0,,17.0,1.0,0.0,1.0,0.0,47.0,1.0,2.0,,7.0,0.0,0.0,,0.0,0.0,,,,,0.0,,0.0,0.0,0.0,3.0,4.0,14.0,2.0,6.0,56.0,5.0,2.0,19.0,8.0,109.0,0.0,3.0,4.0,0.0,,45.0,0.0,,112.0,161.0,,32.0,2.0,0.0,1.0,1.0,0.0,0.0,,0.0,,21.0,2.0,5.0,,,3.0,0.0
2023-08-24 00:00:00+00:00,144.0,,77.0,13.0,,349.0,,72.0,66.0,5.0,14.0,0.0,,70.0,0.0,66.0,11.0,,,0.0,0.0,6.0,21.0,3.0,3.0,,2.0,,6.0,0.0,3.0,,,21.0,7.0,,28.0,10.0,,52.0,9.0,18.0,,0.0,,3.0,0.0,45.0,1.0,,9.0,3.0,0.0,16.0,0.0,0.0,3.0,1.0,,0.0,2.0,0.0,7.0,11.0,1.0,1.0,32.0,0.0,3.0,10.0,48.0,,85.0,4.0,2.0,4.0,0.0,42.0,2.0,0.0,,0.0,0.0,0.0,,0.0,4.0,,,,,2.0,,0.0,2.0,3.0,1.0,4.0,17.0,1.0,16.0,65.0,7.0,0.0,17.0,8.0,80.0,7.0,1.0,6.0,0.0,,50.0,0.0,,61.0,203.0,,23.0,10.0,1.0,0.0,0.0,0.0,0.0,,0.0,,19.0,0.0,1.0,,,2.0,1.0
2023-08-25 00:00:00+00:00,161.0,,98.0,10.0,,357.0,,68.0,56.0,16.0,14.0,0.0,,9.0,0.0,49.0,12.0,,,2.0,0.0,1.0,29.0,9.0,1.0,,3.0,,1.0,8.0,3.0,,,10.0,6.0,,13.0,5.0,,36.0,4.0,27.0,,0.0,,11.0,0.0,38.0,5.0,,3.0,4.0,0.0,11.0,3.0,2.0,14.0,3.0,,1.0,1.0,0.0,19.0,11.0,0.0,6.0,31.0,0.0,0.0,18.0,16.0,,75.0,3.0,0.0,4.0,1.0,47.0,2.0,2.0,,0.0,0.0,0.0,,0.0,2.0,,,,,0.0,,0.0,0.0,3.0,0.0,3.0,1.0,1.0,4.0,62.0,2.0,2.0,13.0,4.0,110.0,6.0,7.0,2.0,0.0,,15.0,0.0,,34.0,182.0,,26.0,3.0,0.0,2.0,2.0,0.0,1.0,,0.0,,2.0,0.0,0.0,,,1.0,0.0
2023-08-26 00:00:00+00:00,272.0,,89.0,6.0,,273.0,,60.0,47.0,9.0,8.0,1.0,,7.0,0.0,57.0,5.0,,,2.0,0.0,2.0,15.0,10.0,1.0,,1.0,,1.0,3.0,2.0,,,7.0,7.0,,12.0,11.0,,24.0,4.0,13.0,,0.0,,30.0,0.0,24.0,2.0,,3.0,4.0,0.0,12.0,2.0,31.0,3.0,1.0,,0.0,3.0,1.0,2.0,8.0,2.0,0.0,38.0,0.0,2.0,5.0,27.0,,77.0,1.0,0.0,2.0,0.0,30.0,1.0,1.0,,8.0,0.0,0.0,,0.0,3.0,,,,,1.0,,0.0,0.0,1.0,0.0,6.0,2.0,0.0,3.0,37.0,4.0,0.0,19.0,2.0,100.0,1.0,0.0,3.0,0.0,,1.0,0.0,,56.0,124.0,,30.0,1.0,0.0,0.0,3.0,0.0,1.0,,0.0,,0.0,1.0,3.0,,,1.0,0.0
2023-08-27 00:00:00+00:00,135.0,,88.0,13.0,,299.0,,35.0,72.0,10.0,11.0,2.0,,3.0,0.0,28.0,3.0,,,0.0,0.0,3.0,6.0,9.0,1.0,,0.0,,3.0,1.0,2.0,,,16.0,8.0,,18.0,9.0,,76.0,4.0,17.0,,0.0,,23.0,1.0,19.0,6.0,,4.0,1.0,1.0,11.0,4.0,33.0,8.0,0.0,,2.0,6.0,0.0,9.0,22.0,1.0,0.0,22.0,0.0,0.0,3.0,44.0,,29.0,0.0,1.0,1.0,0.0,39.0,1.0,0.0,,0.0,0.0,0.0,,0.0,2.0,,,,,2.0,,0.0,1.0,1.0,0.0,5.0,1.0,2.0,2.0,40.0,2.0,0.0,18.0,4.0,86.0,1.0,10.0,2.0,0.0,,4.0,2.0,,26.0,130.0,,14.0,0.0,0.0,1.0,0.0,0.0,2.0,,0.0,,1.0,3.0,4.0,,,0.0,0.0
2023-08-28 00:00:00+00:00,156.0,,90.0,10.0,,364.0,,37.0,47.0,7.0,17.0,1.0,,3.0,0.0,37.0,8.0,,,3.0,0.0,1.0,41.0,7.0,0.0,,2.0,,1.0,3.0,2.0,,,21.0,9.0,,10.0,10.0,,40.0,7.0,44.0,,1.0,,3.0,0.0,23.0,0.0,,38.0,3.0,0.0,10.0,4.0,20.0,11.0,1.0,,0.0,0.0,2.0,4.0,46.0,1.0,2.0,19.0,0.0,1.0,8.0,43.0,,28.0,0.0,2.0,1.0,0.0,35.0,5.0,0.0,,1.0,0.0,0.0,,1.0,1.0,,,,,0.0,,0.0,0.0,0.0,1.0,2.0,2.0,0.0,2.0,30.0,2.0,0.0,11.0,9.0,102.0,3.0,4.0,1.0,0.0,,6.0,1.0,,38.0,148.0,,21.0,2.0,2.0,0.0,1.0,0.0,0.0,,0.0,,3.0,0.0,7.0,,,3.0,0.0
2023-08-29 00:00:00+00:00,145.0,,82.0,10.0,,427.0,,48.0,67.0,2.0,13.0,0.0,,9.0,1.0,43.0,11.0,,,2.0,0.0,2.0,25.0,28.0,4.0,,2.0,,2.0,1.0,6.0,,,20.0,15.0,,14.0,16.0,,21.0,1.0,34.0,,0.0,,7.0,1.0,30.0,4.0,,25.0,2.0,0.0,14.0,0.0,29.0,1.0,3.0,,0.0,0.0,0.0,9.0,12.0,3.0,5.0,25.0,0.0,0.0,4.0,39.0,,28.0,2.0,0.0,3.0,2.0,37.0,6.0,0.0,,0.0,1.0,0.0,,0.0,3.0,,,,,0.0,,0.0,0.0,3.0,0.0,1.0,0.0,3.0,11.0,41.0,4.0,2.0,9.0,7.0,104.0,2.0,4.0,0.0,0.0,,5.0,0.0,,59.0,197.0,,16.0,1.0,0.0,2.0,0.0,0.0,0.0,,0.0,,8.0,1.0,3.0,,,1.0,0.0
2023-08-30 00:00:00+00:00,200.0,,148.0,23.0,,455.0,,59.0,48.0,11.0,10.0,0.0,,6.0,1.0,30.0,3.0,,,1.0,0.0,3.0,11.0,29.0,1.0,,6.0,,5.0,2.0,2.0,,,6.0,17.0,,19.0,12.0,,27.0,4.0,26.0,,0.0,,10.0,0.0,51.0,1.0,,248.0,35.0,0.0,16.0,3.0,4.0,11.0,10.0,,1.0,4.0,1.0,5.0,7.0,2.0,3.0,44.0,0.0,1.0,6.0,20.0,,24.0,2.0,0.0,0.0,0.0,44.0,2.0,2.0,,3.0,0.0,0.0,,1.0,0.0,,,,,2.0,,0.0,3.0,3.0,1.0,3.0,1.0,2.0,6.0,43.0,9.0,1.0,8.0,20.0,142.0,3.0,3.0,4.0,3.0,,18.0,1.0,,51.0,183.0,,20.0,1.0,0.0,1.0,0.0,0.0,2.0,,0.0,,8.0,0.0,2.0,,,2.0,0.0
2023-08-31 00:00:00+00:00,324.0,,247.0,9.0,,440.0,,81.0,45.0,7.0,11.0,1.0,,10.0,0.0,11.0,6.0,,,1.0,0.0,2.0,9.0,21.0,6.0,,8.0,,3.0,3.0,5.0,,,19.0,10.0,,13.0,16.0,,76.0,6.0,32.0,,0.0,,23.0,1.0,31.0,0.0,,32.0,75.0,0.0,13.0,5.0,29.0,5.0,4.0,,0.0,2.0,0.0,7.0,15.0,15.0,2.0,43.0,0.0,1.0,7.0,26.0,,38.0,1.0,0.0,2.0,1.0,27.0,3.0,1.0,,6.0,0.0,0.0,,0.0,2.0,,,,,8.0,,0.0,0.0,3.0,2.0,28.0,2.0,2.0,9.0,40.0,7.0,4.0,14.0,9.0,170.0,2.0,4.0,2.0,1.0,,5.0,0.0,,113.0,210.0,,18.0,0.0,1.0,3.0,1.0,0.0,0.0,,0.0,,16.0,1.0,2.0,,,2.0,0.0
2023-09-01 00:00:00+00:00,302.0,,128.0,12.0,,428.0,,121.0,43.0,16.0,12.0,0.0,,11.0,1.0,31.0,7.0,,,0.0,0.0,3.0,5.0,16.0,2.0,,2.0,,8.0,1.0,2.0,,,14.0,7.0,,22.0,15.0,,50.0,6.0,32.0,,2.0,,11.0,0.0,36.0,5.0,,16.0,68.0,0.0,10.0,8.0,21.0,4.0,1.0,,0.0,2.0,0.0,5.0,20.0,3.0,5.0,29.0,0.0,0.0,8.0,21.0,,57.0,3.0,1.0,4.0,0.0,29.0,1.0,3.0,,3.0,0.0,0.0,,0.0,2.0,,,,,1.0,,0.0,1.0,2.0,7.0,8.0,1.0,1.0,6.0,84.0,4.0,5.0,13.0,5.0,143.0,3.0,4.0,1.0,0.0,,2.0,0.0,,79.0,199.0,,25.0,0.0,4.0,1.0,0.0,0.0,0.0,,0.0,,5.0,2.0,2.0,,,2.0,1.0
2023-09-02 00:00:00+00:00,286.0,,111.0,20.0,,323.0,,149.0,46.0,7.0,12.0,0.0,,8.0,0.0,43.0,16.0,,,0.0,0.0,2.0,5.0,7.0,3.0,,3.0,,2.0,6.0,9.0,,,10.0,28.0,,40.0,9.0,,60.0,3.0,15.0,,0.0,,7.0,0.0,30.0,0.0,,4.0,31.0,0.0,15.0,0.0,28.0,5.0,8.0,,79.0,1.0,0.0,6.0,7.0,4.0,1.0,37.0,0.0,5.0,3.0,18.0,,143.0,4.0,4.0,8.0,0.0,38.0,1.0,4.0,,0.0,0.0,0.0,,1.0,1.0,,,,,0.0,,0.0,0.0,2.0,5.0,1.0,1.0,0.0,7.0,57.0,2.0,1.0,11.0,12.0,90.0,1.0,6.0,7.0,1.0,,3.0,0.0,,36.0,175.0,,16.0,1.0,5.0,2.0,0.0,0.0,2.0,,0.0,,1.0,2.0,2.0,,,8.0,0.0
2023-09-03 00:00:00+00:00,138.0,,94.0,5.0,,342.0,,134.0,61.0,3.0,6.0,0.0,,1.0,0.0,40.0,10.0,,,13.0,0.0,0.0,3.0,21.0,2.0,,5.0,,3.0,1.0,4.0,,,7.0,2.0,,17.0,9.0,,53.0,4.0,18.0,,0.0,,8.0,1.0,52.0,0.0,,20.0,52.0,0.0,8.0,3.0,5.0,5.0,2.0,,58.0,2.0,0.0,14.0,4.0,3.0,5.0,27.0,0.0,1.0,13.0,7.0,,92.0,1.0,0.0,2.0,1.0,39.0,1.0,1.0,,4.0,0.0,0.0,,0.0,1.0,,,,,1.0,,0.0,1.0,0.0,11.0,1.0,0.0,1.0,3.0,40.0,7.0,0.0,22.0,13.0,69.0,0.0,2.0,2.0,0.0,,4.0,0.0,,69.0,122.0,,19.0,0.0,0.0,2.0,0.0,1.0,0.0,,1.0,,1.0,1.0,2.0,,,0.0,0.0
2023-09-04 00:00:00+00:00,212.0,,121.0,10.0,,362.0,,129.0,69.0,12.0,8.0,0.0,,7.0,0.0,29.0,5.0,,,2.0,0.0,2.0,7.0,11.0,4.0,,7.0,,3.0,2.0,5.0,,,11.0,7.0,,20.0,10.0,,55.0,4.0,19.0,,0.0,,57.0,3.0,36.0,4.0,,12.0,109.0,0.0,8.0,2.0,20.0,8.0,2.0,,22.0,3.0,0.0,8.0,3.0,3.0,4.0,32.0,0.0,0.0,8.0,24.0,,58.0,1.0,2.0,6.0,0.0,56.0,3.0,3.0,,4.0,0.0,0.0,,0.0,0.0,,,,,2.0,,0.0,0.0,2.0,1.0,3.0,0.0,4.0,4.0,50.0,3.0,3.0,20.0,11.0,55.0,5.0,2.0,0.0,0.0,,2.0,0.0,,73.0,172.0,,32.0,0.0,3.0,1.0,0.0,0.0,0.0,,0.0,,0.0,0.0,3.0,,,3.0,0.0
2023-09-05 00:00:00+00:00,178.0,,139.0,14.0,,444.0,,102.0,49.0,27.0,7.0,0.0,,8.0,0.0,28.0,7.0,,,6.0,1.0,1.0,12.0,20.0,11.0,,14.0,,12.0,7.0,12.0,,,12.0,8.0,,23.0,12.0,,47.0,3.0,20.0,,0.0,,28.0,5.0,58.0,2.0,,9.0,116.0,0.0,14.0,1.0,38.0,20.0,2.0,,10.0,2.0,2.0,9.0,8.0,1.0,7.0,71.0,0.0,8.0,14.0,11.0,,33.0,3.0,0.0,4.0,0.0,47.0,2.0,2.0,,7.0,0.0,0.0,,1.0,1.0,,,,,0.0,,0.0,0.0,4.0,2.0,8.0,1.0,10.0,16.0,58.0,13.0,5.0,22.0,57.0,77.0,4.0,7.0,1.0,0.0,,7.0,0.0,,84.0,192.0,,45.0,0.0,7.0,1.0,0.0,0.0,0.0,,0.0,,2.0,13.0,6.0,,,1.0,0.0
2023-09-06 00:00:00+00:00,198.0,,118.0,15.0,,433.0,,62.0,76.0,13.0,7.0,0.0,,6.0,0.0,23.0,7.0,,,4.0,0.0,1.0,19.0,27.0,12.0,,5.0,,4.0,1.0,1.0,,,10.0,14.0,,18.0,6.0,,67.0,6.0,25.0,,0.0,,21.0,1.0,58.0,2.0,,16.0,75.0,0.0,16.0,2.0,1.0,12.0,5.0,,10.0,2.0,2.0,10.0,5.0,3.0,9.0,37.0,0.0,15.0,9.0,45.0,,46.0,3.0,1.0,1.0,0.0,54.0,3.0,1.0,,9.0,1.0,0.0,,0.0,5.0,,,,,1.0,,0.0,1.0,33.0,19.0,3.0,0.0,7.0,12.0,44.0,5.0,0.0,29.0,79.0,99.0,11.0,3.0,1.0,9.0,,12.0,0.0,,70.0,226.0,,39.0,1.0,0.0,0.0,0.0,1.0,0.0,,0.0,,19.0,11.0,2.0,,,0.0,0.0
2023-09-07 00:00:00+00:00,251.0,,104.0,25.0,,405.0,,61.0,67.0,7.0,8.0,0.0,,7.0,0.0,42.0,6.0,,,2.0,0.0,3.0,31.0,34.0,7.0,,8.0,,5.0,1.0,4.0,,,11.0,26.0,,22.0,9.0,,57.0,5.0,23.0,,0.0,,16.0,2.0,35.0,22.0,,6.0,47.0,1.0,9.0,1.0,38.0,17.0,3.0,,4.0,1.0,2.0,5.0,4.0,3.0,2.0,47.0,0.0,3.0,16.0,13.0,,40.0,2.0,0.0,6.0,0.0,30.0,8.0,1.0,,10.0,0.0,0.0,,1.0,5.0,,,,,1.0,,0.0,3.0,2.0,8.0,4.0,0.0,13.0,39.0,43.0,1.0,0.0,22.0,70.0,97.0,5.0,32.0,3.0,2.0,,6.0,0.0,,81.0,223.0,,47.0,0.0,1.0,2.0,0.0,0.0,2.0,,0.0,,11.0,3.0,5.0,,,0.0,2.0
2023-09-08 00:00:00+00:00,216.0,,74.0,17.0,,354.0,,50.0,63.0,1.0,14.0,3.0,,4.0,0.0,15.0,8.0,,,2.0,0.0,0.0,22.0,22.0,10.0,,9.0,,4.0,1.0,0.0,,,19.0,10.0,,26.0,13.0,,37.0,3.0,27.0,,0.0,,5.0,1.0,43.0,31.0,,3.0,54.0,0.0,24.0,2.0,59.0,22.0,4.0,,2.0,1.0,1.0,12.0,9.0,1.0,0.0,43.0,0.0,16.0,12.0,21.0,,29.0,3.0,0.0,5.0,0.0,32.0,7.0,1.0,,4.0,0.0,0.0,,0.0,3.0,,,,,1.0,,0.0,1.0,2.0,9.0,2.0,1.0,8.0,174.0,48.0,5.0,3.0,18.0,208.0,87.0,0.0,3.0,6.0,1.0,,4.0,0.0,,77.0,182.0,,35.0,0.0,0.0,0.0,0.0,0.0,0.0,,2.0,,6.0,1.0,4.0,,,0.0,0.0
2023-09-09 00:00:00+00:00,244.0,,79.0,9.0,,330.0,,28.0,37.0,6.0,14.0,0.0,,14.0,0.0,19.0,7.0,,,0.0,0.0,1.0,15.0,4.0,1.0,,9.0,,4.0,0.0,2.0,,,5.0,2.0,,5.0,12.0,,52.0,6.0,16.0,,0.0,,15.0,1.0,38.0,3.0,,3.0,58.0,0.0,6.0,1.0,19.0,8.0,3.0,,3.0,1.0,0.0,8.0,4.0,1.0,5.0,31.0,0.0,0.0,7.0,8.0,,23.0,6.0,0.0,1.0,0.0,60.0,4.0,1.0,,0.0,0.0,0.0,,1.0,0.0,,,,,1.0,,0.0,2.0,2.0,3.0,0.0,2.0,1.0,141.0,31.0,5.0,2.0,18.0,148.0,75.0,1.0,2.0,1.0,1.0,,4.0,0.0,,41.0,170.0,,22.0,2.0,8.0,0.0,0.0,0.0,0.0,,0.0,,2.0,1.0,2.0,,,2.0,0.0
2023-09-10 00:00:00+00:00,114.0,,62.0,17.0,,327.0,,57.0,41.0,4.0,10.0,3.0,,6.0,0.0,18.0,1.0,,,3.0,0.0,6.0,24.0,17.0,3.0,,12.0,,11.0,0.0,2.0,,,10.0,4.0,,19.0,6.0,,33.0,3.0,14.0,,0.0,,23.0,1.0,22.0,9.0,,1.0,23.0,0.0,9.0,1.0,21.0,6.0,1.0,,2.0,6.0,0.0,4.0,1.0,3.0,2.0,31.0,0.0,1.0,14.0,19.0,,34.0,0.0,0.0,4.0,0.0,29.0,1.0,1.0,,2.0,0.0,0.0,,0.0,1.0,,,,,1.0,,0.0,2.0,1.0,0.0,1.0,1.0,4.0,105.0,42.0,5.0,0.0,18.0,168.0,59.0,1.0,0.0,2.0,1.0,,3.0,0.0,,33.0,164.0,,15.0,0.0,2.0,2.0,0.0,0.0,0.0,,0.0,,1.0,1.0,1.0,,,1.0,0.0
2023-09-11 00:00:00+00:00,168.0,,74.0,35.0,,355.0,,66.0,59.0,41.0,8.0,2.0,,3.0,1.0,27.0,6.0,,,2.0,0.0,9.0,23.0,33.0,8.0,,12.0,,19.0,11.0,2.0,,,26.0,6.0,,48.0,7.0,,38.0,9.0,36.0,,0.0,,7.0,2.0,39.0,6.0,,1.0,53.0,0.0,16.0,3.0,21.0,13.0,4.0,,2.0,1.0,2.0,2.0,7.0,1.0,3.0,40.0,0.0,1.0,5.0,22.0,,44.0,5.0,0.0,2.0,1.0,35.0,7.0,0.0,,4.0,0.0,0.0,,0.0,1.0,,,,,1.0,,0.0,0.0,1.0,3.0,5.0,0.0,4.0,14.0,45.0,17.0,0.0,26.0,50.0,68.0,4.0,1.0,0.0,2.0,,2.0,1.0,,34.0,404.0,,21.0,0.0,0.0,1.0,0.0,0.0,0.0,,0.0,,2.0,0.0,1.0,,,2.0,0.0
2023-09-12 00:00:00+00:00,173.0,,83.0,12.0,,369.0,,72.0,62.0,10.0,11.0,0.0,,8.0,0.0,13.0,8.0,,,5.0,0.0,3.0,17.0,21.0,3.0,,5.0,,16.0,8.0,5.0,,,14.0,8.0,,43.0,11.0,,32.0,10.0,19.0,,0.0,,5.0,0.0,59.0,1.0,,1.0,40.0,0.0,41.0,1.0,25.0,17.0,3.0,,3.0,0.0,2.0,3.0,7.0,0.0,2.0,39.0,0.0,1.0,25.0,7.0,,27.0,7.0,1.0,1.0,1.0,25.0,4.0,2.0,,5.0,0.0,0.0,,0.0,4.0,,,,,0.0,,0.0,2.0,2.0,4.0,2.0,1.0,3.0,18.0,62.0,10.0,13.0,26.0,30.0,97.0,1.0,2.0,0.0,3.0,,7.0,0.0,,57.0,229.0,,48.0,0.0,2.0,0.0,0.0,0.0,2.0,,0.0,,8.0,2.0,3.0,,,3.0,0.0
2023-09-13 00:00:00+00:00,159.0,,80.0,8.0,,339.0,,54.0,69.0,3.0,17.0,1.0,,4.0,0.0,42.0,4.0,,,1.0,0.0,1.0,10.0,15.0,8.0,,4.0,,17.0,44.0,1.0,,,30.0,9.0,,24.0,7.0,,47.0,7.0,38.0,,0.0,,7.0,0.0,45.0,2.0,,3.0,42.0,0.0,27.0,2.0,50.0,5.0,0.0,,6.0,0.0,3.0,5.0,4.0,4.0,3.0,24.0,0.0,3.0,20.0,16.0,,26.0,2.0,0.0,0.0,0.0,43.0,4.0,1.0,,30.0,0.0,0.0,,0.0,3.0,,,,,0.0,,0.0,2.0,22.0,2.0,2.0,2.0,5.0,8.0,47.0,3.0,1.0,18.0,24.0,82.0,1.0,0.0,1.0,0.0,,1.0,0.0,,54.0,165.0,,24.0,0.0,1.0,5.0,0.0,0.0,1.0,,0.0,,1.0,8.0,1.0,,,0.0,1.0
2023-09-14 00:00:00+00:00,183.0,,73.0,6.0,,378.0,,63.0,47.0,13.0,18.0,0.0,,6.0,0.0,44.0,20.0,,,1.0,0.0,4.0,10.0,9.0,17.0,,5.0,,11.0,16.0,1.0,,,16.0,9.0,,26.0,10.0,,59.0,7.0,42.0,,0.0,,11.0,2.0,42.0,3.0,,3.0,51.0,0.0,21.0,0.0,47.0,14.0,2.0,,0.0,0.0,13.0,2.0,6.0,1.0,1.0,48.0,0.0,2.0,23.0,4.0,,32.0,2.0,0.0,2.0,0.0,62.0,2.0,0.0,,3.0,0.0,0.0,,0.0,4.0,,,,,1.0,,0.0,0.0,8.0,3.0,6.0,3.0,4.0,7.0,50.0,18.0,3.0,16.0,17.0,80.0,2.0,0.0,1.0,1.0,,3.0,0.0,,49.0,178.0,,45.0,1.0,1.0,4.0,1.0,0.0,0.0,,0.0,,5.0,9.0,1.0,,,5.0,0.0
2023-09-15 00:00:00+00:00,227.0,,85.0,8.0,,375.0,,87.0,55.0,2.0,13.0,1.0,,5.0,0.0,51.0,15.0,,,1.0,0.0,4.0,6.0,5.0,14.0,,1.0,,8.0,4.0,0.0,,,11.0,2.0,,31.0,5.0,,53.0,6.0,26.0,,0.0,,7.0,1.0,20.0,13.0,,0.0,63.0,0.0,27.0,3.0,40.0,16.0,5.0,,6.0,0.0,6.0,11.0,15.0,7.0,2.0,22.0,0.0,2.0,5.0,3.0,,35.0,1.0,0.0,0.0,0.0,96.0,1.0,1.0,,9.0,0.0,0.0,,0.0,2.0,,,,,0.0,,0.0,1.0,2.0,0.0,4.0,0.0,5.0,6.0,39.0,35.0,9.0,20.0,6.0,69.0,4.0,3.0,0.0,1.0,,5.0,0.0,,44.0,150.0,,43.0,0.0,1.0,1.0,0.0,0.0,0.0,,1.0,,2.0,2.0,6.0,,,13.0,0.0
2023-09-16 00:00:00+00:00,163.0,,63.0,15.0,,385.0,,41.0,57.0,6.0,12.0,0.0,,6.0,0.0,35.0,3.0,,,1.0,0.0,7.0,12.0,2.0,1.0,,7.0,,0.0,0.0,5.0,,,8.0,4.0,,13.0,6.0,,19.0,2.0,12.0,,0.0,,14.0,0.0,37.0,4.0,,0.0,46.0,0.0,14.0,3.0,227.0,8.0,0.0,,4.0,4.0,3.0,9.0,0.0,1.0,2.0,22.0,0.0,0.0,7.0,5.0,,48.0,0.0,0.0,0.0,0.0,40.0,1.0,1.0,,3.0,0.0,0.0,,0.0,3.0,,,,,0.0,,0.0,1.0,0.0,3.0,7.0,2.0,4.0,1.0,39.0,38.0,4.0,16.0,22.0,56.0,5.0,4.0,1.0,0.0,,0.0,0.0,,46.0,158.0,,17.0,0.0,1.0,2.0,2.0,0.0,0.0,,0.0,,1.0,0.0,0.0,,,10.0,0.0
2023-09-17 00:00:00+00:00,138.0,,49.0,13.0,,342.0,,54.0,28.0,7.0,10.0,1.0,,4.0,0.0,49.0,6.0,,,0.0,0.0,1.0,11.0,5.0,3.0,,2.0,,3.0,2.0,3.0,,,7.0,3.0,,14.0,6.0,,55.0,0.0,19.0,,0.0,,21.0,0.0,20.0,1.0,,0.0,29.0,0.0,10.0,0.0,158.0,3.0,0.0,,13.0,14.0,2.0,3.0,4.0,2.0,1.0,23.0,0.0,8.0,6.0,11.0,,31.0,1.0,0.0,1.0,0.0,25.0,0.0,0.0,,0.0,0.0,0.0,,0.0,1.0,,,,,3.0,,0.0,0.0,2.0,5.0,4.0,6.0,2.0,4.0,33.0,22.0,8.0,9.0,25.0,59.0,3.0,2.0,2.0,2.0,,2.0,1.0,,38.0,135.0,,18.0,0.0,1.0,0.0,2.0,0.0,1.0,,2.0,,2.0,0.0,6.0,,,3.0,0.0
2023-09-18 00:00:00+00:00,250.0,,57.0,22.0,,316.0,,58.0,50.0,3.0,19.0,0.0,,4.0,0.0,37.0,4.0,,,6.0,0.0,2.0,8.0,19.0,15.0,,6.0,,11.0,9.0,5.0,,,12.0,2.0,,10.0,10.0,,38.0,5.0,37.0,,0.0,,2.0,1.0,20.0,6.0,,0.0,61.0,0.0,11.0,0.0,462.0,12.0,1.0,,0.0,0.0,6.0,4.0,1.0,3.0,2.0,36.0,0.0,0.0,7.0,9.0,,45.0,1.0,0.0,2.0,0.0,74.0,2.0,1.0,,0.0,0.0,0.0,,0.0,2.0,,,,,1.0,,0.0,0.0,6.0,5.0,11.0,9.0,3.0,3.0,48.0,20.0,1.0,32.0,55.0,81.0,5.0,3.0,2.0,2.0,,1.0,0.0,,37.0,141.0,,17.0,1.0,4.0,0.0,0.0,0.0,0.0,,0.0,,4.0,1.0,4.0,,,4.0,0.0
2023-09-19 00:00:00+00:00,207.0,,81.0,22.0,,408.0,,54.0,85.0,0.0,25.0,2.0,,9.0,0.0,15.0,9.0,,,5.0,0.0,1.0,11.0,18.0,8.0,,6.0,,22.0,0.0,3.0,,,12.0,1.0,,17.0,9.0,,55.0,4.0,26.0,,0.0,,42.0,0.0,54.0,3.0,,1.0,32.0,1.0,34.0,1.0,337.0,11.0,3.0,,0.0,0.0,1.0,2.0,4.0,1.0,3.0,57.0,0.0,2.0,8.0,13.0,,38.0,4.0,0.0,0.0,0.0,50.0,0.0,0.0,,2.0,1.0,0.0,,0.0,6.0,,,,,3.0,,0.0,2.0,1.0,3.0,1.0,3.0,6.0,8.0,41.0,45.0,1.0,16.0,32.0,91.0,0.0,2.0,2.0,1.0,,10.0,0.0,,38.0,176.0,,17.0,1.0,0.0,2.0,0.0,0.0,0.0,,0.0,,3.0,0.0,5.0,,,2.0,0.0
2023-09-20 00:00:00+00:00,296.0,,77.0,24.0,,409.0,,75.0,86.0,11.0,25.0,0.0,,4.0,0.0,23.0,8.0,,,3.0,0.0,1.0,13.0,8.0,6.0,,13.0,,2.0,6.0,4.0,,,21.0,4.0,,16.0,8.0,,39.0,4.0,33.0,,0.0,,46.0,0.0,39.0,0.0,,4.0,78.0,1.0,25.0,7.0,43.0,9.0,9.0,,1.0,1.0,3.0,9.0,118.0,5.0,1.0,33.0,0.0,4.0,8.0,19.0,,32.0,4.0,1.0,2.0,0.0,54.0,2.0,2.0,,12.0,0.0,0.0,,0.0,2.0,,,,,0.0,,0.0,2.0,5.0,0.0,7.0,4.0,3.0,6.0,49.0,53.0,0.0,32.0,20.0,86.0,7.0,5.0,1.0,0.0,,0.0,0.0,,46.0,175.0,,24.0,2.0,0.0,2.0,0.0,1.0,0.0,,0.0,,3.0,3.0,136.0,,,6.0,0.0
2023-09-21 00:00:00+00:00,256.0,,71.0,18.0,,355.0,,85.0,52.0,3.0,11.0,0.0,,4.0,0.0,23.0,5.0,,,3.0,0.0,7.0,23.0,15.0,5.0,,6.0,,4.0,3.0,3.0,,,7.0,17.0,,12.0,4.0,,45.0,3.0,35.0,,0.0,,7.0,0.0,48.0,8.0,,2.0,48.0,1.0,22.0,2.0,78.0,7.0,8.0,,1.0,1.0,1.0,2.0,32.0,8.0,4.0,44.0,0.0,1.0,5.0,18.0,,35.0,1.0,0.0,2.0,0.0,40.0,2.0,8.0,,17.0,0.0,0.0,,1.0,3.0,,,,,0.0,,0.0,1.0,1.0,0.0,0.0,2.0,9.0,6.0,64.0,132.0,6.0,32.0,21.0,95.0,4.0,2.0,7.0,2.0,,9.0,1.0,,32.0,193.0,,24.0,1.0,0.0,2.0,0.0,2.0,1.0,,0.0,,3.0,0.0,39.0,,,0.0,0.0
2023-09-22 00:00:00+00:00,256.0,,81.0,9.0,,411.0,,53.0,61.0,7.0,11.0,1.0,,7.0,0.0,14.0,4.0,,,0.0,0.0,6.0,10.0,38.0,14.0,,5.0,,19.0,4.0,5.0,,,9.0,9.0,,37.0,9.0,,38.0,2.0,21.0,,0.0,,9.0,0.0,18.0,1.0,,2.0,64.0,0.0,9.0,0.0,54.0,17.0,1.0,,0.0,13.0,1.0,15.0,10.0,4.0,3.0,53.0,0.0,20.0,6.0,19.0,,39.0,3.0,1.0,3.0,0.0,39.0,1.0,57.0,,3.0,0.0,0.0,,0.0,2.0,,,,,0.0,,0.0,1.0,0.0,1.0,3.0,7.0,9.0,5.0,62.0,107.0,1.0,14.0,9.0,66.0,2.0,2.0,4.0,0.0,,7.0,0.0,,57.0,180.0,,32.0,2.0,0.0,0.0,0.0,0.0,0.0,,0.0,,0.0,0.0,28.0,,,3.0,0.0
2023-09-23 00:00:00+00:00,196.0,,64.0,10.0,,299.0,,38.0,49.0,5.0,18.0,1.0,,1.0,1.0,26.0,5.0,,,1.0,0.0,7.0,6.0,13.0,11.0,,4.0,,3.0,0.0,1.0,,,8.0,20.0,,14.0,9.0,,58.0,1.0,12.0,,0.0,,16.0,3.0,32.0,0.0,,1.0,36.0,0.0,7.0,0.0,88.0,1.0,1.0,,0.0,2.0,0.0,6.0,4.0,3.0,3.0,31.0,0.0,5.0,7.0,9.0,,42.0,0.0,1.0,1.0,0.0,70.0,3.0,3.0,,4.0,0.0,0.0,,0.0,3.0,,,,,0.0,,0.0,1.0,2.0,4.0,1.0,11.0,6.0,1.0,39.0,57.0,0.0,11.0,39.0,80.0,4.0,3.0,1.0,0.0,,10.0,0.0,,39.0,134.0,,20.0,2.0,1.0,5.0,0.0,0.0,0.0,,0.0,,1.0,0.0,2.0,,,0.0,0.0
2023-09-24 00:00:00+00:00,237.0,,52.0,11.0,,316.0,,52.0,53.0,3.0,11.0,0.0,,2.0,1.0,35.0,5.0,,,1.0,1.0,2.0,20.0,17.0,6.0,,5.0,,6.0,11.0,1.0,,,13.0,16.0,,12.0,10.0,,25.0,3.0,18.0,,0.0,,12.0,1.0,11.0,3.0,,0.0,46.0,0.0,28.0,1.0,10.0,6.0,0.0,,1.0,2.0,0.0,3.0,3.0,2.0,1.0,20.0,0.0,6.0,9.0,14.0,,40.0,0.0,0.0,0.0,0.0,27.0,2.0,0.0,,2.0,0.0,0.0,,0.0,2.0,,,,,2.0,,0.0,0.0,4.0,8.0,0.0,6.0,1.0,7.0,39.0,30.0,11.0,17.0,20.0,63.0,1.0,12.0,1.0,0.0,,13.0,0.0,,53.0,156.0,,10.0,1.0,0.0,0.0,0.0,0.0,0.0,,0.0,,0.0,0.0,0.0,,,0.0,0.0
2023-09-25 00:00:00+00:00,319.0,,69.0,13.0,,356.0,,58.0,48.0,6.0,8.0,1.0,,4.0,0.0,40.0,1.0,,,2.0,0.0,2.0,15.0,25.0,2.0,,5.0,,8.0,6.0,2.0,,,19.0,12.0,,9.0,15.0,,72.0,2.0,22.0,,0.0,,18.0,1.0,27.0,0.0,,2.0,54.0,0.0,10.0,2.0,44.0,7.0,2.0,,1.0,0.0,0.0,6.0,8.0,5.0,2.0,24.0,0.0,5.0,3.0,8.0,,37.0,1.0,0.0,1.0,0.0,64.0,4.0,5.0,,11.0,0.0,0.0,,0.0,4.0,,,,,1.0,,0.0,1.0,6.0,11.0,3.0,0.0,2.0,18.0,65.0,34.0,2.0,23.0,8.0,110.0,4.0,4.0,4.0,10.0,,16.0,0.0,,44.0,159.0,,24.0,0.0,0.0,2.0,1.0,0.0,0.0,,1.0,,2.0,0.0,2.0,,,2.0,0.0
2023-09-26 00:00:00+00:00,229.0,,66.0,16.0,,389.0,,89.0,56.0,3.0,11.0,5.0,,4.0,0.0,35.0,5.0,,,4.0,1.0,2.0,22.0,23.0,9.0,,2.0,,22.0,3.0,1.0,,,13.0,8.0,,14.0,8.0,,52.0,2.0,23.0,,0.0,,5.0,0.0,30.0,6.0,,1.0,68.0,1.0,21.0,2.0,60.0,13.0,11.0,,1.0,0.0,0.0,6.0,12.0,15.0,8.0,39.0,0.0,2.0,8.0,12.0,,30.0,0.0,0.0,1.0,0.0,42.0,1.0,0.0,,0.0,0.0,0.0,,0.0,1.0,,,,,0.0,,0.0,2.0,3.0,13.0,4.0,3.0,3.0,7.0,45.0,37.0,3.0,18.0,18.0,61.0,4.0,2.0,3.0,4.0,,8.0,0.0,,44.0,130.0,,29.0,0.0,1.0,1.0,0.0,0.0,1.0,,2.0,,2.0,3.0,7.0,,,2.0,2.0
2023-09-27 00:00:00+00:00,227.0,,70.0,17.0,,345.0,,96.0,37.0,5.0,20.0,1.0,,8.0,0.0,62.0,4.0,,,2.0,0.0,0.0,12.0,6.0,4.0,,3.0,,7.0,0.0,1.0,,,16.0,7.0,,17.0,7.0,,27.0,2.0,20.0,,0.0,,16.0,1.0,40.0,4.0,,6.0,41.0,0.0,7.0,1.0,143.0,8.0,8.0,,0.0,1.0,0.0,13.0,5.0,5.0,9.0,31.0,0.0,1.0,13.0,14.0,,36.0,1.0,0.0,1.0,0.0,124.0,2.0,1.0,,3.0,0.0,0.0,,0.0,3.0,,,,,2.0,,0.0,0.0,2.0,11.0,2.0,5.0,4.0,6.0,49.0,64.0,5.0,26.0,10.0,81.0,0.0,0.0,2.0,3.0,,3.0,0.0,,60.0,158.0,,26.0,0.0,0.0,2.0,0.0,0.0,0.0,,1.0,,2.0,0.0,4.0,,,0.0,0.0
2023-09-28 00:00:00+00:00,302.0,,78.0,24.0,,389.0,,106.0,42.0,13.0,16.0,1.0,,6.0,0.0,45.0,17.0,,,1.0,0.0,5.0,3.0,10.0,5.0,,4.0,,2.0,0.0,4.0,,,8.0,9.0,,14.0,15.0,,36.0,1.0,27.0,,0.0,,5.0,1.0,46.0,5.0,,2.0,53.0,1.0,22.0,3.0,93.0,7.0,5.0,,1.0,2.0,3.0,6.0,8.0,10.0,5.0,37.0,0.0,2.0,13.0,5.0,,28.0,0.0,0.0,2.0,0.0,147.0,1.0,0.0,,1.0,0.0,0.0,,0.0,1.0,,,,,1.0,,0.0,0.0,3.0,12.0,0.0,2.0,5.0,7.0,48.0,55.0,0.0,13.0,20.0,91.0,4.0,0.0,1.0,3.0,,14.0,0.0,,66.0,126.0,,28.0,0.0,1.0,2.0,0.0,0.0,0.0,,0.0,,7.0,1.0,5.0,,,4.0,0.0
2023-09-29 00:00:00+00:00,225.0,,65.0,12.0,,336.0,,82.0,34.0,7.0,16.0,0.0,,13.0,0.0,62.0,9.0,,,38.0,0.0,1.0,7.0,16.0,1.0,,4.0,,10.0,6.0,1.0,,,15.0,8.0,,9.0,9.0,,39.0,1.0,19.0,,0.0,,12.0,0.0,34.0,4.0,,1.0,42.0,0.0,16.0,9.0,30.0,12.0,7.0,,1.0,1.0,0.0,6.0,13.0,4.0,1.0,30.0,0.0,3.0,15.0,9.0,,31.0,1.0,2.0,0.0,0.0,134.0,3.0,2.0,,8.0,0.0,0.0,,0.0,0.0,,,,,0.0,,0.0,1.0,1.0,7.0,4.0,0.0,4.0,4.0,58.0,47.0,0.0,18.0,16.0,60.0,0.0,4.0,3.0,3.0,,4.0,0.0,,52.0,163.0,,26.0,1.0,0.0,2.0,0.0,0.0,0.0,,2.0,,2.0,0.0,6.0,,,4.0,0.0
2023-09-30 00:00:00+00:00,278.0,,50.0,15.0,,325.0,,63.0,45.0,18.0,10.0,0.0,,6.0,0.0,60.0,6.0,,,9.0,0.0,1.0,7.0,8.0,0.0,,7.0,,14.0,0.0,1.0,,,7.0,11.0,,8.0,10.0,,40.0,2.0,11.0,,0.0,,8.0,0.0,33.0,5.0,,0.0,42.0,0.0,11.0,0.0,45.0,6.0,13.0,,0.0,0.0,1.0,8.0,7.0,2.0,0.0,31.0,0.0,1.0,9.0,3.0,,40.0,0.0,0.0,1.0,0.0,258.0,0.0,1.0,,5.0,0.0,0.0,,1.0,1.0,,,,,1.0,,0.0,0.0,1.0,5.0,6.0,0.0,4.0,2.0,41.0,43.0,0.0,25.0,5.0,61.0,0.0,2.0,0.0,3.0,,11.0,0.0,,41.0,135.0,,20.0,2.0,2.0,0.0,0.0,0.0,0.0,,1.0,,1.0,0.0,0.0,,,14.0,1.0
2023-10-01 00:00:00+00:00,218.0,,50.0,12.0,,331.0,,72.0,51.0,10.0,16.0,1.0,,5.0,0.0,101.0,3.0,,,9.0,1.0,5.0,7.0,9.0,5.0,,5.0,,8.0,3.0,9.0,,,14.0,4.0,,22.0,6.0,,54.0,0.0,18.0,,0.0,,8.0,0.0,17.0,2.0,,2.0,34.0,0.0,11.0,1.0,18.0,8.0,32.0,,1.0,3.0,1.0,2.0,4.0,15.0,1.0,31.0,0.0,0.0,7.0,23.0,,22.0,0.0,0.0,1.0,0.0,35.0,2.0,2.0,,1.0,0.0,0.0,,1.0,2.0,,,,,4.0,,0.0,0.0,0.0,2.0,2.0,0.0,0.0,1.0,35.0,29.0,0.0,24.0,15.0,71.0,2.0,3.0,2.0,0.0,,21.0,0.0,,25.0,141.0,,26.0,0.0,0.0,4.0,0.0,0.0,2.0,,0.0,,0.0,0.0,1.0,,,4.0,0.0
2023-10-02 00:00:00+00:00,404.0,,49.0,14.0,,360.0,,64.0,51.0,5.0,8.0,0.0,,8.0,0.0,70.0,9.0,,,3.0,0.0,0.0,6.0,18.0,5.0,,7.0,,13.0,4.0,10.0,,,11.0,6.0,,15.0,20.0,,35.0,1.0,21.0,,0.0,,6.0,1.0,28.0,4.0,,4.0,51.0,0.0,11.0,2.0,67.0,6.0,11.0,,1.0,0.0,1.0,4.0,12.0,8.0,2.0,39.0,0.0,1.0,12.0,20.0,,31.0,0.0,0.0,4.0,1.0,35.0,10.0,1.0,,0.0,1.0,0.0,,0.0,1.0,,,,,3.0,,0.0,0.0,1.0,11.0,3.0,0.0,2.0,4.0,54.0,38.0,0.0,14.0,11.0,69.0,2.0,2.0,1.0,2.0,,26.0,0.0,,34.0,187.0,,23.0,1.0,1.0,1.0,0.0,0.0,0.0,,0.0,,3.0,2.0,1.0,,,3.0,0.0
2023-10-03 00:00:00+00:00,355.0,,67.0,14.0,,389.0,,66.0,46.0,10.0,28.0,1.0,,2.0,0.0,40.0,5.0,,,1.0,1.0,7.0,5.0,26.0,9.0,,11.0,,8.0,3.0,1.0,,,13.0,4.0,,53.0,17.0,,47.0,8.0,34.0,,0.0,,16.0,0.0,40.0,4.0,,2.0,57.0,0.0,22.0,0.0,20.0,12.0,18.0,,3.0,7.0,3.0,16.0,14.0,6.0,8.0,75.0,0.0,12.0,12.0,12.0,,38.0,1.0,0.0,5.0,1.0,29.0,7.0,5.0,,4.0,0.0,0.0,,1.0,1.0,,,,,1.0,,0.0,0.0,9.0,6.0,5.0,0.0,1.0,13.0,50.0,29.0,1.0,24.0,6.0,88.0,5.0,8.0,2.0,1.0,,9.0,0.0,,41.0,172.0,,30.0,2.0,0.0,3.0,0.0,0.0,0.0,,0.0,,1.0,0.0,2.0,,,6.0,1.0
2023-10-04 00:00:00+00:00,239.0,,57.0,11.0,,385.0,,50.0,42.0,1.0,29.0,0.0,,5.0,0.0,49.0,20.0,,,2.0,0.0,4.0,21.0,17.0,1.0,,6.0,,3.0,0.0,9.0,,,17.0,18.0,,26.0,6.0,,38.0,19.0,15.0,,0.0,,9.0,1.0,50.0,7.0,,2.0,79.0,0.0,12.0,3.0,66.0,10.0,45.0,,1.0,0.0,0.0,6.0,2.0,1.0,3.0,49.0,0.0,12.0,8.0,6.0,,29.0,0.0,1.0,2.0,0.0,54.0,0.0,9.0,,2.0,0.0,0.0,,0.0,2.0,,,,,1.0,,,1.0,7.0,4.0,3.0,0.0,1.0,5.0,28.0,24.0,2.0,21.0,12.0,85.0,1.0,1.0,1.0,0.0,,33.0,0.0,,62.0,210.0,,13.0,4.0,1.0,0.0,0.0,0.0,0.0,,0.0,,5.0,0.0,3.0,,,15.0,0.0
2023-10-05 00:00:00+00:00,239.0,,88.0,40.0,,399.0,,89.0,54.0,5.0,10.0,0.0,,10.0,0.0,80.0,9.0,,,6.0,0.0,3.0,6.0,35.0,7.0,,4.0,,14.0,1.0,5.0,,,12.0,15.0,,18.0,9.0,,40.0,16.0,33.0,,0.0,,6.0,0.0,32.0,7.0,,1.0,62.0,0.0,12.0,1.0,45.0,3.0,16.0,,0.0,1.0,1.0,2.0,3.0,6.0,3.0,59.0,0.0,3.0,11.0,12.0,,40.0,4.0,0.0,0.0,0.0,44.0,0.0,5.0,,2.0,0.0,0.0,,0.0,2.0,,,,,1.0,,,0.0,0.0,5.0,5.0,1.0,3.0,5.0,66.0,23.0,1.0,17.0,3.0,100.0,4.0,0.0,4.0,0.0,,19.0,0.0,,51.0,191.0,,16.0,1.0,0.0,0.0,0.0,0.0,0.0,,1.0,,3.0,0.0,2.0,,,9.0,0.0
2023-10-06 00:00:00+00:00,201.0,,79.0,15.0,,352.0,,39.0,34.0,13.0,20.0,0.0,,2.0,0.0,224.0,5.0,,,5.0,1.0,0.0,12.0,25.0,11.0,,5.0,,12.0,4.0,4.0,,,10.0,12.0,,11.0,11.0,,31.0,14.0,24.0,,1.0,,26.0,0.0,36.0,2.0,,3.0,81.0,0.0,18.0,0.0,57.0,15.0,10.0,,1.0,1.0,0.0,7.0,10.0,12.0,2.0,34.0,0.0,4.0,5.0,7.0,,40.0,0.0,0.0,4.0,0.0,34.0,2.0,0.0,,2.0,0.0,0.0,,0.0,3.0,,,,,2.0,,,0.0,3.0,5.0,2.0,1.0,1.0,3.0,43.0,18.0,1.0,18.0,14.0,136.0,0.0,1.0,4.0,2.0,,16.0,0.0,,42.0,186.0,,23.0,4.0,1.0,1.0,0.0,0.0,1.0,,0.0,,5.0,0.0,3.0,,,3.0,1.0
2023-10-07 00:00:00+00:00,127.0,,46.0,6.0,,318.0,,60.0,41.0,15.0,11.0,1.0,,4.0,0.0,145.0,19.0,,,0.0,0.0,2.0,3.0,13.0,4.0,,3.0,,13.0,7.0,1.0,,,6.0,8.0,,15.0,10.0,,31.0,34.0,15.0,,0.0,,11.0,0.0,24.0,3.0,,1.0,43.0,0.0,12.0,0.0,49.0,3.0,5.0,,0.0,0.0,0.0,7.0,11.0,6.0,2.0,27.0,0.0,3.0,15.0,7.0,,22.0,3.0,0.0,6.0,0.0,37.0,1.0,0.0,,2.0,0.0,0.0,,1.0,5.0,,,,,15.0,,,0.0,3.0,3.0,2.0,1.0,5.0,2.0,35.0,16.0,0.0,22.0,10.0,70.0,0.0,1.0,5.0,2.0,,13.0,0.0,,35.0,123.0,,15.0,0.0,0.0,5.0,0.0,0.0,0.0,,0.0,,0.0,0.0,4.0,,,2.0,0.0
2023-10-08 00:00:00+00:00,124.0,,57.0,8.0,,337.0,,38.0,38.0,10.0,9.0,0.0,,1.0,0.0,76.0,18.0,,,4.0,0.0,2.0,5.0,9.0,5.0,,33.0,,1.0,0.0,3.0,,,15.0,1.0,,20.0,11.0,,44.0,38.0,17.0,,2.0,,7.0,0.0,28.0,14.0,,0.0,53.0,0.0,14.0,20.0,28.0,0.0,15.0,,5.0,0.0,4.0,87.0,10.0,8.0,4.0,37.0,0.0,2.0,7.0,5.0,,25.0,2.0,0.0,1.0,0.0,25.0,0.0,2.0,,0.0,0.0,0.0,,2.0,1.0,,,,,3.0,,,1.0,0.0,5.0,1.0,1.0,6.0,4.0,40.0,14.0,0.0,18.0,7.0,67.0,1.0,1.0,2.0,0.0,,7.0,0.0,,51.0,134.0,,12.0,1.0,0.0,1.0,1.0,0.0,0.0,,0.0,,0.0,0.0,4.0,,,1.0,0.0
2023-10-09 00:00:00+00:00,196.0,,83.0,8.0,,329.0,,42.0,36.0,16.0,21.0,0.0,,10.0,0.0,42.0,19.0,,,1.0,0.0,2.0,4.0,21.0,10.0,,18.0,,1.0,3.0,1.0,,,11.0,5.0,,13.0,11.0,,53.0,22.0,19.0,,0.0,,19.0,0.0,19.0,14.0,,7.0,57.0,0.0,10.0,5.0,25.0,11.0,39.0,,10.0,0.0,1.0,113.0,4.0,9.0,24.0,36.0,0.0,2.0,10.0,32.0,,38.0,0.0,1.0,1.0,0.0,59.0,3.0,0.0,,0.0,0.0,0.0,,2.0,4.0,,,,,7.0,,,0.0,0.0,3.0,2.0,1.0,3.0,2.0,41.0,21.0,0.0,20.0,13.0,68.0,2.0,0.0,7.0,0.0,,5.0,0.0,,94.0,152.0,,23.0,1.0,1.0,1.0,0.0,0.0,0.0,,1.0,,0.0,2.0,4.0,,,0.0,0.0
2023-10-10 00:00:00+00:00,211.0,,70.0,20.0,,381.0,,42.0,37.0,6.0,9.0,1.0,,9.0,0.0,51.0,11.0,,,4.0,0.0,2.0,3.0,46.0,5.0,,13.0,,3.0,2.0,1.0,,,12.0,4.0,,12.0,9.0,,34.0,22.0,24.0,,0.0,,3.0,0.0,20.0,7.0,,3.0,26.0,0.0,11.0,1.0,53.0,6.0,27.0,,3.0,1.0,1.0,33.0,6.0,8.0,1.0,39.0,0.0,0.0,15.0,6.0,,35.0,0.0,0.0,1.0,0.0,49.0,1.0,0.0,,0.0,0.0,0.0,,0.0,4.0,,,,,1.0,,,3.0,2.0,4.0,2.0,0.0,5.0,4.0,40.0,25.0,0.0,20.0,7.0,71.0,5.0,0.0,5.0,4.0,,14.0,0.0,,174.0,149.0,,24.0,1.0,1.0,0.0,0.0,1.0,0.0,,0.0,,3.0,1.0,6.0,,,7.0,0.0
2023-10-11 00:00:00+00:00,186.0,,55.0,14.0,,357.0,,84.0,50.0,22.0,22.0,1.0,,3.0,0.0,47.0,11.0,,,1.0,0.0,3.0,3.0,89.0,1.0,,13.0,,14.0,3.0,2.0,,,8.0,23.0,,16.0,3.0,,26.0,21.0,34.0,,0.0,,2.0,4.0,37.0,7.0,,0.0,50.0,1.0,14.0,1.0,26.0,5.0,10.0,,1.0,0.0,9.0,40.0,6.0,5.0,6.0,39.0,0.0,1.0,7.0,9.0,,30.0,2.0,1.0,1.0,0.0,47.0,1.0,1.0,,1.0,0.0,0.0,,1.0,3.0,,,,,1.0,,,0.0,0.0,0.0,2.0,1.0,5.0,3.0,53.0,18.0,3.0,26.0,9.0,70.0,8.0,0.0,13.0,0.0,,5.0,0.0,,101.0,168.0,,19.0,1.0,1.0,0.0,0.0,0.0,0.0,,1.0,,0.0,1.0,6.0,,,2.0,0.0
2023-10-12 00:00:00+00:00,204.0,,90.0,14.0,,358.0,,57.0,45.0,9.0,13.0,0.0,,9.0,0.0,90.0,13.0,,,1.0,0.0,1.0,5.0,67.0,10.0,,5.0,,27.0,3.0,2.0,,,8.0,38.0,,17.0,7.0,,38.0,22.0,27.0,,0.0,,6.0,2.0,28.0,3.0,,4.0,61.0,0.0,5.0,3.0,29.0,12.0,10.0,,0.0,0.0,9.0,25.0,11.0,4.0,2.0,27.0,0.0,0.0,4.0,6.0,,28.0,0.0,0.0,6.0,1.0,49.0,3.0,1.0,,3.0,0.0,0.0,,0.0,2.0,,,,,3.0,,,1.0,0.0,0.0,2.0,1.0,1.0,6.0,49.0,20.0,1.0,21.0,6.0,93.0,2.0,5.0,3.0,0.0,,9.0,0.0,,101.0,197.0,,28.0,1.0,1.0,0.0,0.0,0.0,0.0,,0.0,,3.0,0.0,2.0,,,2.0,0.0
2023-10-13 00:00:00+00:00,124.0,,103.0,12.0,,340.0,,56.0,46.0,13.0,18.0,0.0,,7.0,0.0,88.0,24.0,,,1.0,0.0,2.0,8.0,46.0,6.0,,7.0,,26.0,1.0,3.0,,,5.0,14.0,,13.0,8.0,,51.0,24.0,14.0,,0.0,,20.0,1.0,33.0,0.0,,2.0,70.0,0.0,13.0,13.0,30.0,7.0,15.0,,0.0,2.0,2.0,26.0,5.0,5.0,8.0,25.0,0.0,0.0,12.0,5.0,,28.0,1.0,0.0,2.0,0.0,55.0,4.0,3.0,,0.0,0.0,0.0,,0.0,4.0,,,,,4.0,,,0.0,1.0,1.0,3.0,2.0,3.0,6.0,34.0,29.0,4.0,24.0,21.0,84.0,1.0,2.0,3.0,9.0,,5.0,0.0,,47.0,146.0,,15.0,2.0,4.0,0.0,0.0,0.0,0.0,,0.0,,6.0,0.0,5.0,,,0.0,0.0
2023-10-14 00:00:00+00:00,125.0,,72.0,11.0,,265.0,,44.0,46.0,10.0,25.0,0.0,,2.0,0.0,54.0,19.0,,,0.0,0.0,3.0,3.0,18.0,6.0,,13.0,,4.0,3.0,2.0,,,5.0,21.0,,13.0,3.0,,31.0,35.0,16.0,,0.0,,27.0,0.0,55.0,0.0,,0.0,27.0,0.0,13.0,16.0,48.0,15.0,7.0,,0.0,1.0,2.0,11.0,2.0,13.0,3.0,33.0,0.0,0.0,24.0,8.0,,32.0,0.0,1.0,5.0,0.0,28.0,2.0,2.0,,0.0,0.0,0.0,,1.0,3.0,,,,,1.0,,,3.0,1.0,1.0,0.0,0.0,3.0,16.0,31.0,19.0,0.0,14.0,9.0,57.0,1.0,5.0,2.0,0.0,,5.0,0.0,,60.0,130.0,,20.0,2.0,1.0,0.0,0.0,1.0,0.0,,0.0,,1.0,1.0,2.0,,,0.0,0.0
2023-10-15 00:00:00+00:00,101.0,,102.0,18.0,,272.0,,36.0,52.0,12.0,24.0,0.0,,3.0,0.0,35.0,12.0,,,2.0,0.0,0.0,2.0,11.0,4.0,,19.0,,13.0,5.0,2.0,,,16.0,10.0,,13.0,5.0,,38.0,12.0,36.0,,0.0,,18.0,1.0,37.0,2.0,,2.0,36.0,0.0,10.0,12.0,41.0,3.0,16.0,,1.0,1.0,2.0,33.0,14.0,1.0,2.0,33.0,0.0,1.0,11.0,13.0,,46.0,2.0,0.0,2.0,0.0,33.0,0.0,1.0,,6.0,0.0,0.0,,0.0,4.0,,,,,11.0,,,1.0,0.0,1.0,2.0,0.0,7.0,3.0,40.0,28.0,1.0,16.0,13.0,58.0,1.0,8.0,1.0,2.0,,6.0,0.0,,51.0,147.0,,16.0,2.0,3.0,0.0,0.0,0.0,0.0,,0.0,,1.0,0.0,1.0,,,1.0,0.0
2023-10-16 00:00:00+00:00,112.0,,199.0,6.0,,383.0,,53.0,36.0,9.0,18.0,0.0,,6.0,0.0,42.0,13.0,,,2.0,0.0,2.0,9.0,28.0,3.0,,6.0,,7.0,11.0,1.0,,,8.0,5.0,,12.0,4.0,,35.0,25.0,72.0,,0.0,,5.0,0.0,36.0,4.0,,4.0,90.0,0.0,13.0,7.0,32.0,11.0,8.0,,0.0,1.0,1.0,43.0,1.0,4.0,6.0,36.0,0.0,0.0,6.0,6.0,,36.0,0.0,2.0,2.0,0.0,36.0,1.0,3.0,,2.0,0.0,0.0,,0.0,4.0,,,,,0.0,,,0.0,2.0,1.0,4.0,1.0,5.0,6.0,55.0,18.0,0.0,18.0,14.0,52.0,5.0,3.0,5.0,1.0,,1.0,0.0,,56.0,220.0,,12.0,0.0,1.0,1.0,0.0,0.0,0.0,,0.0,,5.0,0.0,3.0,,,1.0,0.0
2023-10-17 00:00:00+00:00,111.0,,156.0,7.0,,362.0,,49.0,40.0,19.0,17.0,0.0,,8.0,0.0,49.0,23.0,,,2.0,0.0,1.0,20.0,22.0,5.0,,25.0,,7.0,3.0,1.0,,,14.0,22.0,,27.0,7.0,,39.0,22.0,31.0,,0.0,,6.0,0.0,50.0,4.0,,1.0,74.0,0.0,9.0,64.0,76.0,10.0,3.0,,0.0,0.0,6.0,45.0,39.0,1.0,10.0,30.0,0.0,3.0,4.0,18.0,,34.0,0.0,0.0,4.0,0.0,46.0,6.0,13.0,,3.0,0.0,0.0,,2.0,3.0,,,,,0.0,,,0.0,0.0,1.0,0.0,1.0,5.0,6.0,36.0,24.0,0.0,27.0,4.0,96.0,3.0,3.0,8.0,2.0,,5.0,2.0,,64.0,178.0,,15.0,3.0,1.0,3.0,0.0,0.0,0.0,,2.0,,9.0,0.0,2.0,,,1.0,0.0
2023-10-18 00:00:00+00:00,114.0,,127.0,10.0,,402.0,,38.0,86.0,6.0,15.0,1.0,,7.0,0.0,33.0,23.0,,,5.0,0.0,1.0,4.0,23.0,7.0,,9.0,,7.0,1.0,5.0,,,21.0,3.0,,61.0,11.0,,20.0,21.0,40.0,,0.0,,4.0,0.0,46.0,3.0,,0.0,90.0,0.0,14.0,45.0,36.0,12.0,8.0,,0.0,2.0,2.0,70.0,3.0,1.0,7.0,31.0,0.0,0.0,8.0,7.0,,29.0,0.0,1.0,8.0,0.0,43.0,2.0,6.0,,4.0,0.0,0.0,,3.0,5.0,,,,,1.0,,,0.0,2.0,0.0,6.0,2.0,6.0,6.0,53.0,14.0,0.0,28.0,4.0,73.0,2.0,4.0,11.0,0.0,,2.0,0.0,,68.0,173.0,,20.0,2.0,5.0,2.0,0.0,0.0,1.0,,0.0,,13.0,1.0,2.0,,,0.0,0.0
2023-10-19 00:00:00+00:00,177.0,,67.0,13.0,,336.0,,25.0,114.0,7.0,14.0,2.0,,8.0,0.0,54.0,17.0,,,4.0,0.0,3.0,6.0,53.0,8.0,,17.0,,4.0,5.0,4.0,,,11.0,23.0,,28.0,3.0,,31.0,21.0,18.0,,0.0,,5.0,0.0,45.0,0.0,,1.0,50.0,0.0,18.0,41.0,42.0,8.0,8.0,,1.0,13.0,1.0,21.0,7.0,2.0,4.0,35.0,0.0,0.0,10.0,78.0,,33.0,1.0,0.0,7.0,0.0,33.0,0.0,7.0,,2.0,0.0,1.0,,3.0,1.0,,,,,0.0,,,0.0,4.0,0.0,4.0,0.0,8.0,4.0,50.0,8.0,3.0,11.0,9.0,75.0,2.0,5.0,1.0,0.0,,3.0,0.0,,69.0,153.0,,15.0,0.0,4.0,4.0,0.0,0.0,0.0,,0.0,,14.0,0.0,3.0,,,2.0,0.0
2023-10-20 00:00:00+00:00,133.0,,101.0,13.0,,371.0,,28.0,123.0,4.0,20.0,2.0,,9.0,0.0,48.0,32.0,,,4.0,0.0,1.0,1.0,14.0,5.0,,4.0,,2.0,4.0,1.0,,,8.0,14.0,,15.0,12.0,,24.0,19.0,16.0,,0.0,,5.0,0.0,27.0,2.0,,1.0,78.0,0.0,14.0,18.0,57.0,5.0,2.0,,1.0,10.0,2.0,19.0,4.0,2.0,2.0,33.0,0.0,3.0,7.0,265.0,,19.0,3.0,1.0,3.0,0.0,65.0,2.0,1.0,,3.0,0.0,0.0,,0.0,0.0,,,,,0.0,,,1.0,1.0,2.0,2.0,0.0,0.0,2.0,47.0,21.0,0.0,26.0,7.0,60.0,4.0,3.0,2.0,0.0,,2.0,1.0,,45.0,131.0,,22.0,0.0,4.0,2.0,0.0,0.0,0.0,,0.0,,9.0,1.0,2.0,,,0.0,0.0
2023-10-21 00:00:00+00:00,187.0,,75.0,17.0,,264.0,,30.0,117.0,7.0,24.0,2.0,,7.0,0.0,36.0,11.0,,,0.0,0.0,1.0,10.0,10.0,2.0,,11.0,,0.0,4.0,8.0,,,17.0,3.0,,6.0,4.0,,8.0,29.0,17.0,,0.0,,17.0,0.0,30.0,7.0,,2.0,37.0,0.0,13.0,19.0,49.0,12.0,6.0,,0.0,15.0,0.0,18.0,1.0,4.0,0.0,34.0,0.0,1.0,1.0,8.0,,14.0,0.0,0.0,4.0,0.0,38.0,1.0,4.0,,3.0,0.0,0.0,,0.0,4.0,,,,,6.0,,,0.0,1.0,1.0,4.0,0.0,0.0,7.0,44.0,16.0,1.0,12.0,2.0,50.0,2.0,3.0,3.0,0.0,,2.0,0.0,,32.0,144.0,,23.0,0.0,1.0,0.0,0.0,0.0,0.0,,0.0,,3.0,0.0,0.0,,,2.0,0.0
2023-10-22 00:00:00+00:00,320.0,,65.0,22.0,,265.0,,22.0,72.0,9.0,23.0,0.0,,6.0,0.0,69.0,16.0,,,1.0,0.0,0.0,1.0,29.0,6.0,,2.0,,13.0,1.0,4.0,,,8.0,4.0,,8.0,7.0,,16.0,31.0,17.0,,0.0,,9.0,0.0,47.0,4.0,,4.0,43.0,0.0,8.0,9.0,23.0,4.0,5.0,,0.0,5.0,0.0,11.0,9.0,4.0,5.0,41.0,0.0,0.0,6.0,7.0,,17.0,1.0,0.0,3.0,0.0,47.0,3.0,1.0,,1.0,0.0,0.0,,0.0,1.0,,,,,2.0,,,0.0,2.0,0.0,1.0,0.0,3.0,1.0,26.0,14.0,1.0,12.0,6.0,47.0,0.0,3.0,7.0,0.0,,5.0,0.0,,26.0,97.0,,5.0,2.0,1.0,3.0,0.0,0.0,1.0,,0.0,,1.0,4.0,1.0,,,0.0,0.0
2023-10-23 00:00:00+00:00,357.0,,140.0,29.0,,340.0,,53.0,197.0,9.0,11.0,2.0,,14.0,0.0,121.0,23.0,,,4.0,0.0,1.0,7.0,17.0,16.0,,5.0,,3.0,15.0,5.0,,,9.0,4.0,,9.0,6.0,,12.0,22.0,31.0,,0.0,,23.0,0.0,47.0,2.0,,0.0,101.0,0.0,7.0,9.0,81.0,16.0,3.0,,1.0,0.0,0.0,11.0,3.0,11.0,1.0,43.0,0.0,3.0,8.0,13.0,24.0,30.0,2.0,0.0,3.0,1.0,45.0,4.0,1.0,,10.0,0.0,0.0,114.0,0.0,1.0,,,,,1.0,,,1.0,1.0,2.0,6.0,1.0,2.0,7.0,41.0,19.0,1.0,31.0,17.0,44.0,5.0,3.0,1.0,0.0,,5.0,0.0,,23.0,167.0,,16.0,1.0,1.0,0.0,0.0,0.0,1.0,,0.0,,2.0,5.0,4.0,1.0,,1.0,0.0
2023-10-24 00:00:00+00:00,219.0,,86.0,15.0,,305.0,,50.0,208.0,12.0,24.0,0.0,,25.0,0.0,81.0,25.0,,,3.0,0.0,2.0,10.0,32.0,16.0,,14.0,,6.0,4.0,13.0,,,41.0,26.0,,15.0,18.0,,69.0,28.0,28.0,,0.0,,6.0,0.0,51.0,4.0,,3.0,67.0,0.0,11.0,12.0,32.0,23.0,17.0,,1.0,0.0,0.0,21.0,6.0,14.0,2.0,47.0,0.0,0.0,7.0,43.0,36.0,38.0,1.0,2.0,1.0,0.0,62.0,5.0,14.0,,4.0,0.0,0.0,108.0,1.0,0.0,,,,,1.0,,,1.0,4.0,1.0,15.0,0.0,2.0,3.0,31.0,19.0,0.0,29.0,17.0,50.0,10.0,10.0,6.0,1.0,,4.0,2.0,,36.0,164.0,,19.0,1.0,2.0,0.0,0.0,0.0,0.0,,0.0,,7.0,8.0,2.0,0.0,,2.0,0.0
2023-10-25 00:00:00+00:00,272.0,,64.0,11.0,,255.0,,48.0,150.0,7.0,13.0,0.0,,16.0,0.0,74.0,20.0,,,0.0,0.0,6.0,10.0,20.0,5.0,,8.0,,1.0,3.0,2.0,,,17.0,14.0,,9.0,3.0,,73.0,28.0,20.0,,3.0,,8.0,1.0,16.0,1.0,,6.0,75.0,0.0,8.0,4.0,85.0,26.0,23.0,,0.0,0.0,0.0,21.0,3.0,8.0,3.0,18.0,0.0,2.0,10.0,22.0,11.0,29.0,0.0,0.0,4.0,0.0,54.0,3.0,6.0,,21.0,0.0,0.0,84.0,4.0,0.0,,,,,5.0,,,2.0,9.0,1.0,1.0,0.0,5.0,5.0,44.0,13.0,1.0,8.0,13.0,42.0,4.0,4.0,1.0,0.0,,5.0,0.0,,26.0,116.0,,19.0,0.0,8.0,1.0,0.0,0.0,0.0,,0.0,,9.0,2.0,3.0,0.0,,4.0,0.0
2023-10-26 00:00:00+00:00,200.0,,123.0,15.0,,264.0,,33.0,132.0,15.0,13.0,1.0,,10.0,0.0,48.0,10.0,,,2.0,0.0,0.0,12.0,19.0,10.0,,2.0,,7.0,15.0,1.0,,,9.0,14.0,,8.0,9.0,,41.0,21.0,27.0,,1.0,,12.0,0.0,29.0,4.0,,1.0,93.0,0.0,7.0,5.0,95.0,16.0,34.0,,0.0,1.0,0.0,9.0,5.0,8.0,3.0,36.0,13.0,1.0,2.0,24.0,28.0,12.0,5.0,0.0,6.0,1.0,37.0,4.0,7.0,,5.0,0.0,0.0,75.0,1.0,3.0,,,,,0.0,,,6.0,2.0,0.0,3.0,1.0,3.0,1.0,46.0,13.0,0.0,17.0,15.0,46.0,0.0,1.0,3.0,0.0,,2.0,0.0,,32.0,112.0,,19.0,0.0,1.0,0.0,0.0,1.0,1.0,,0.0,,13.0,3.0,4.0,2.0,,1.0,0.0
2023-10-27 00:00:00+00:00,221.0,,118.0,18.0,,231.0,,29.0,157.0,18.0,6.0,1.0,,2.0,0.0,60.0,10.0,,,4.0,0.0,1.0,9.0,8.0,9.0,,2.0,,11.0,0.0,1.0,,,2.0,5.0,,3.0,7.0,,15.0,23.0,9.0,,0.0,,2.0,1.0,27.0,0.0,,1.0,37.0,0.0,5.0,2.0,50.0,2.0,12.0,,1.0,1.0,0.0,3.0,2.0,5.0,1.0,24.0,36.0,1.0,2.0,49.0,6.0,21.0,0.0,0.0,1.0,0.0,38.0,2.0,3.0,,7.0,0.0,0.0,61.0,0.0,0.0,,,,,0.0,,,2.0,2.0,0.0,1.0,1.0,3.0,3.0,27.0,28.0,1.0,17.0,8.0,57.0,2.0,0.0,4.0,0.0,,4.0,0.0,,32.0,92.0,,13.0,5.0,1.0,2.0,0.0,1.0,0.0,,0.0,,4.0,2.0,3.0,6.0,,0.0,0.0
2023-10-28 00:00:00+00:00,164.0,,60.0,9.0,,201.0,,22.0,111.0,10.0,11.0,0.0,,4.0,0.0,81.0,11.0,,,3.0,0.0,1.0,4.0,8.0,4.0,,0.0,,2.0,3.0,2.0,,,10.0,10.0,,4.0,4.0,,10.0,15.0,10.0,,0.0,,5.0,0.0,6.0,2.0,,1.0,26.0,0.0,1.0,3.0,26.0,5.0,0.0,,1.0,2.0,0.0,9.0,2.0,6.0,2.0,16.0,10.0,1.0,0.0,23.0,18.0,24.0,0.0,0.0,3.0,0.0,30.0,0.0,4.0,,2.0,0.0,0.0,43.0,0.0,2.0,,,,,0.0,,,1.0,0.0,3.0,5.0,0.0,1.0,2.0,24.0,17.0,1.0,11.0,6.0,33.0,3.0,0.0,4.0,0.0,,0.0,0.0,,24.0,67.0,,14.0,0.0,1.0,3.0,0.0,0.0,0.0,,0.0,,0.0,0.0,2.0,1.0,,1.0,0.0
2023-10-29 00:00:00+00:00,108.0,,60.0,6.0,,232.0,,22.0,122.0,5.0,7.0,0.0,,6.0,0.0,71.0,5.0,,,4.0,0.0,0.0,7.0,13.0,3.0,,11.0,,0.0,0.0,2.0,,,6.0,1.0,,6.0,8.0,,18.0,29.0,15.0,,0.0,,1.0,0.0,6.0,7.0,,1.0,41.0,0.0,11.0,1.0,14.0,22.0,2.0,,0.0,2.0,1.0,10.0,1.0,16.0,9.0,17.0,7.0,5.0,3.0,13.0,18.0,24.0,2.0,0.0,1.0,0.0,37.0,0.0,0.0,,0.0,0.0,0.0,58.0,0.0,2.0,,,,,1.0,,,2.0,0.0,0.0,1.0,2.0,1.0,4.0,30.0,12.0,1.0,3.0,4.0,52.0,1.0,1.0,1.0,0.0,,2.0,0.0,,30.0,75.0,,19.0,0.0,2.0,0.0,1.0,0.0,0.0,,0.0,,1.0,0.0,1.0,0.0,,0.0,0.0
2023-10-30 00:00:00+00:00,183.0,,75.0,9.0,,263.0,,35.0,259.0,2.0,10.0,0.0,,9.0,0.0,60.0,15.0,,,3.0,0.0,0.0,5.0,21.0,9.0,,14.0,,18.0,3.0,1.0,,,33.0,9.0,,7.0,6.0,,18.0,20.0,15.0,,1.0,,17.0,0.0,5.0,1.0,,2.0,60.0,0.0,3.0,15.0,248.0,3.0,6.0,,0.0,0.0,1.0,17.0,2.0,15.0,7.0,18.0,8.0,3.0,2.0,21.0,23.0,30.0,0.0,1.0,1.0,1.0,39.0,7.0,3.0,,6.0,0.0,0.0,72.0,0.0,2.0,,,,,2.0,,,2.0,2.0,3.0,7.0,1.0,5.0,2.0,39.0,14.0,0.0,6.0,11.0,56.0,5.0,1.0,2.0,0.0,,2.0,0.0,,42.0,98.0,,14.0,4.0,0.0,2.0,0.0,0.0,0.0,,0.0,,7.0,0.0,1.0,2.0,,0.0,0.0
2023-10-31 00:00:00+00:00,166.0,,85.0,14.0,,246.0,,36.0,186.0,14.0,4.0,0.0,,8.0,0.0,122.0,27.0,,,4.0,0.0,3.0,4.0,19.0,1.0,,16.0,,7.0,4.0,3.0,,,101.0,3.0,,33.0,5.0,,22.0,22.0,24.0,,1.0,,4.0,0.0,9.0,0.0,,1.0,49.0,0.0,8.0,10.0,128.0,5.0,3.0,,1.0,1.0,2.0,3.0,2.0,6.0,3.0,106.0,14.0,7.0,3.0,24.0,18.0,14.0,2.0,0.0,4.0,0.0,60.0,3.0,2.0,,3.0,0.0,0.0,78.0,1.0,1.0,,,,,1.0,,,4.0,3.0,2.0,4.0,1.0,4.0,8.0,35.0,13.0,0.0,13.0,5.0,56.0,2.0,0.0,2.0,0.0,,2.0,0.0,,30.0,99.0,,14.0,6.0,0.0,1.0,1.0,0.0,0.0,,0.0,,9.0,0.0,0.0,0.0,,7.0,1.0
2023-11-01 00:00:00+00:00,144.0,,83.0,20.0,,243.0,,36.0,142.0,2.0,41.0,0.0,,5.0,0.0,104.0,25.0,,,20.0,0.0,1.0,10.0,32.0,2.0,,10.0,,6.0,4.0,8.0,,,24.0,8.0,,65.0,4.0,,65.0,18.0,21.0,,0.0,,6.0,1.0,21.0,1.0,,3.0,60.0,0.0,8.0,10.0,30.0,6.0,7.0,,0.0,11.0,0.0,18.0,3.0,7.0,5.0,22.0,20.0,3.0,3.0,29.0,28.0,25.0,1.0,1.0,10.0,0.0,58.0,3.0,2.0,,11.0,0.0,0.0,61.0,0.0,1.0,,,,,2.0,,,2.0,1.0,0.0,1.0,0.0,3.0,1.0,35.0,12.0,0.0,17.0,12.0,50.0,6.0,0.0,2.0,2.0,,2.0,0.0,,21.0,109.0,,11.0,1.0,1.0,0.0,0.0,0.0,0.0,,0.0,,14.0,3.0,0.0,0.0,,5.0,0.0
2023-11-02 00:00:00+00:00,147.0,,74.0,37.0,,306.0,,17.0,143.0,2.0,34.0,0.0,,2.0,0.0,32.0,16.0,,,7.0,0.0,0.0,4.0,36.0,7.0,,5.0,,15.0,2.0,4.0,,,66.0,15.0,,54.0,9.0,,36.0,17.0,33.0,,1.0,,1.0,2.0,9.0,0.0,,3.0,47.0,1.0,11.0,7.0,35.0,3.0,4.0,,0.0,3.0,1.0,8.0,6.0,11.0,9.0,29.0,37.0,20.0,7.0,5.0,20.0,25.0,1.0,0.0,6.0,1.0,48.0,1.0,1.0,,5.0,0.0,0.0,55.0,0.0,2.0,,,,,0.0,,,0.0,1.0,3.0,2.0,0.0,1.0,3.0,35.0,16.0,0.0,16.0,10.0,54.0,2.0,5.0,4.0,0.0,,3.0,0.0,,27.0,103.0,,14.0,3.0,3.0,0.0,0.0,0.0,1.0,,0.0,,11.0,1.0,5.0,4.0,,2.0,1.0
2023-11-03 00:00:00+00:00,130.0,,46.0,24.0,,242.0,,36.0,76.0,9.0,8.0,0.0,,3.0,0.0,72.0,7.0,,,3.0,0.0,2.0,5.0,22.0,6.0,,11.0,,5.0,0.0,0.0,,,43.0,8.0,,27.0,1.0,,17.0,25.0,18.0,,0.0,,7.0,0.0,5.0,1.0,,4.0,79.0,0.0,6.0,3.0,52.0,1.0,8.0,,0.0,1.0,0.0,10.0,7.0,4.0,11.0,24.0,16.0,5.0,1.0,18.0,13.0,17.0,1.0,0.0,9.0,0.0,21.0,2.0,0.0,,4.0,0.0,0.0,87.0,0.0,1.0,,,,,3.0,,,0.0,0.0,3.0,0.0,0.0,2.0,3.0,34.0,23.0,0.0,9.0,11.0,58.0,38.0,4.0,2.0,0.0,,1.0,0.0,,16.0,98.0,,16.0,2.0,6.0,1.0,0.0,0.0,0.0,,0.0,,16.0,1.0,2.0,0.0,,1.0,0.0
2023-11-04 00:00:00+00:00,138.0,,49.0,25.0,,230.0,,38.0,81.0,17.0,10.0,0.0,,5.0,0.0,67.0,32.0,,,4.0,0.0,1.0,2.0,13.0,9.0,,4.0,,3.0,9.0,5.0,,,17.0,8.0,,15.0,4.0,,17.0,44.0,11.0,,0.0,,2.0,0.0,5.0,3.0,,2.0,61.0,0.0,8.0,11.0,81.0,0.0,6.0,,1.0,0.0,5.0,10.0,1.0,10.0,5.0,16.0,9.0,0.0,4.0,6.0,10.0,12.0,0.0,1.0,6.0,0.0,14.0,3.0,1.0,,17.0,0.0,0.0,30.0,1.0,2.0,,,,,0.0,,,1.0,1.0,2.0,1.0,1.0,1.0,8.0,41.0,11.0,1.0,21.0,8.0,33.0,69.0,5.0,1.0,2.0,,1.0,10.0,,26.0,248.0,,8.0,0.0,0.0,0.0,0.0,0.0,1.0,,0.0,,1.0,2.0,2.0,0.0,,1.0,0.0
2023-11-05 00:00:00+00:00,175.0,,72.0,23.0,,203.0,,18.0,106.0,2.0,20.0,0.0,,1.0,0.0,49.0,22.0,,,2.0,0.0,2.0,20.0,19.0,6.0,,4.0,,4.0,3.0,16.0,,,21.0,0.0,,10.0,4.0,,54.0,5.0,13.0,,0.0,,44.0,0.0,2.0,28.0,,3.0,50.0,0.0,3.0,19.0,9.0,0.0,1.0,,0.0,0.0,0.0,9.0,3.0,5.0,5.0,11.0,14.0,5.0,2.0,9.0,23.0,5.0,1.0,0.0,1.0,0.0,32.0,2.0,0.0,,48.0,0.0,0.0,41.0,0.0,2.0,,,,,4.0,,,1.0,0.0,0.0,1.0,1.0,1.0,2.0,36.0,8.0,1.0,8.0,12.0,35.0,0.0,5.0,2.0,1.0,,3.0,2.0,,19.0,87.0,,12.0,0.0,1.0,0.0,0.0,1.0,0.0,,0.0,,0.0,15.0,0.0,2.0,,2.0,0.0
2023-11-06 00:00:00+00:00,210.0,,103.0,49.0,,304.0,,40.0,209.0,6.0,11.0,0.0,,8.0,0.0,59.0,30.0,,,1.0,0.0,3.0,13.0,24.0,15.0,,5.0,,5.0,10.0,8.0,,,31.0,13.0,,22.0,10.0,,20.0,29.0,24.0,,1.0,,20.0,0.0,13.0,24.0,,1.0,60.0,0.0,6.0,6.0,56.0,7.0,15.0,,0.0,0.0,5.0,18.0,2.0,13.0,9.0,32.0,18.0,15.0,9.0,10.0,30.0,7.0,0.0,0.0,7.0,1.0,28.0,3.0,1.0,,69.0,0.0,0.0,59.0,0.0,2.0,,,,,3.0,,,4.0,2.0,7.0,5.0,1.0,1.0,6.0,55.0,17.0,5.0,23.0,16.0,47.0,1.0,0.0,5.0,2.0,,2.0,3.0,,29.0,106.0,,14.0,0.0,2.0,2.0,0.0,0.0,2.0,,0.0,,6.0,8.0,4.0,4.0,,2.0,0.0
2023-11-07 00:00:00+00:00,203.0,,107.0,24.0,,280.0,,32.0,138.0,3.0,21.0,0.0,,2.0,0.0,54.0,28.0,,,3.0,2.0,1.0,5.0,12.0,7.0,,14.0,,5.0,6.0,1.0,,,34.0,8.0,,12.0,6.0,,33.0,23.0,15.0,,0.0,,4.0,2.0,11.0,7.0,,42.0,61.0,0.0,7.0,6.0,59.0,11.0,6.0,,1.0,2.0,2.0,5.0,0.0,8.0,15.0,67.0,48.0,3.0,4.0,10.0,67.0,12.0,0.0,0.0,3.0,1.0,17.0,1.0,0.0,,13.0,0.0,0.0,76.0,0.0,3.0,,,,,1.0,,,1.0,1.0,9.0,2.0,2.0,3.0,7.0,27.0,15.0,0.0,11.0,20.0,59.0,0.0,2.0,6.0,0.0,,1.0,0.0,,39.0,86.0,,21.0,5.0,3.0,0.0,1.0,0.0,2.0,,0.0,,6.0,2.0,4.0,2.0,,1.0,0.0
2023-11-08 00:00:00+00:00,289.0,,88.0,36.0,,334.0,,39.0,109.0,8.0,15.0,0.0,,5.0,0.0,84.0,11.0,,,2.0,0.0,7.0,8.0,24.0,4.0,,33.0,,16.0,2.0,3.0,,,26.0,8.0,,15.0,9.0,,27.0,24.0,15.0,,2.0,,5.0,3.0,28.0,3.0,,10.0,102.0,0.0,10.0,2.0,46.0,4.0,4.0,,1.0,0.0,0.0,24.0,6.0,10.0,10.0,39.0,10.0,2.0,4.0,12.0,74.0,21.0,1.0,2.0,2.0,0.0,29.0,2.0,0.0,,26.0,1.0,0.0,72.0,0.0,3.0,,,,,1.0,,,2.0,3.0,2.0,1.0,1.0,6.0,4.0,42.0,11.0,2.0,34.0,12.0,37.0,5.0,6.0,3.0,3.0,,2.0,0.0,,45.0,192.0,,18.0,1.0,0.0,1.0,1.0,0.0,0.0,,0.0,,5.0,3.0,4.0,4.0,,3.0,0.0
2023-11-09 00:00:00+00:00,282.0,,84.0,25.0,,379.0,,36.0,74.0,13.0,18.0,6.0,,9.0,0.0,78.0,5.0,,,2.0,0.0,7.0,9.0,18.0,6.0,,10.0,,14.0,0.0,3.0,,,41.0,6.0,,14.0,12.0,,33.0,20.0,19.0,,0.0,,23.0,1.0,40.0,2.0,,2.0,89.0,0.0,10.0,3.0,74.0,13.0,0.0,,0.0,1.0,1.0,27.0,2.0,9.0,7.0,27.0,162.0,7.0,9.0,10.0,91.0,21.0,2.0,3.0,5.0,0.0,27.0,4.0,0.0,,51.0,0.0,0.0,99.0,1.0,1.0,,,,,1.0,,,1.0,2.0,2.0,2.0,4.0,3.0,6.0,68.0,10.0,0.0,24.0,11.0,69.0,1.0,29.0,3.0,1.0,,3.0,0.0,,25.0,166.0,,14.0,3.0,4.0,5.0,2.0,0.0,1.0,,0.0,,11.0,9.0,5.0,1.0,,1.0,0.0
2023-11-10 00:00:00+00:00,221.0,,93.0,15.0,,358.0,,33.0,118.0,49.0,24.0,16.0,,25.0,0.0,43.0,34.0,,,5.0,0.0,3.0,13.0,19.0,12.0,,14.0,,15.0,1.0,7.0,,,32.0,8.0,,16.0,16.0,,30.0,24.0,20.0,,1.0,,20.0,0.0,49.0,0.0,,0.0,150.0,0.0,8.0,0.0,58.0,8.0,4.0,,1.0,3.0,15.0,16.0,4.0,8.0,6.0,36.0,28.0,5.0,3.0,18.0,89.0,23.0,4.0,1.0,0.0,1.0,45.0,3.0,4.0,,28.0,0.0,0.0,54.0,0.0,2.0,,,,,2.0,,,2.0,4.0,0.0,2.0,2.0,3.0,9.0,67.0,10.0,1.0,19.0,12.0,47.0,2.0,19.0,4.0,0.0,,4.0,3.0,,43.0,158.0,,16.0,0.0,1.0,1.0,0.0,0.0,1.0,,0.0,,4.0,7.0,5.0,1.0,,1.0,1.0
2023-11-11 00:00:00+00:00,237.0,,87.0,15.0,,295.0,,20.0,135.0,7.0,28.0,0.0,,85.0,0.0,82.0,10.0,,,5.0,0.0,2.0,10.0,21.0,2.0,,46.0,,13.0,2.0,17.0,,,40.0,1.0,,10.0,12.0,,27.0,31.0,9.0,,0.0,,4.0,5.0,30.0,1.0,,1.0,41.0,0.0,6.0,1.0,43.0,3.0,1.0,,3.0,2.0,2.0,38.0,5.0,9.0,2.0,34.0,14.0,1.0,4.0,33.0,28.0,41.0,2.0,0.0,2.0,1.0,30.0,2.0,0.0,,25.0,0.0,0.0,121.0,0.0,2.0,,,,,1.0,,,0.0,0.0,1.0,2.0,0.0,8.0,10.0,56.0,9.0,1.0,18.0,4.0,38.0,0.0,10.0,1.0,0.0,,2.0,0.0,,29.0,175.0,,12.0,0.0,5.0,0.0,0.0,0.0,0.0,,0.0,,1.0,2.0,0.0,6.0,,0.0,0.0
2023-11-12 00:00:00+00:00,156.0,,74.0,33.0,,249.0,,18.0,82.0,10.0,17.0,1.0,,29.0,0.0,101.0,9.0,,,0.0,0.0,3.0,4.0,20.0,1.0,,62.0,,15.0,4.0,19.0,,,34.0,4.0,,17.0,5.0,,30.0,35.0,13.0,,0.0,,5.0,2.0,5.0,0.0,,1.0,44.0,0.0,5.0,2.0,32.0,1.0,2.0,,1.0,2.0,5.0,77.0,1.0,5.0,4.0,25.0,6.0,0.0,8.0,51.0,31.0,52.0,0.0,0.0,2.0,0.0,11.0,2.0,0.0,,41.0,0.0,0.0,66.0,0.0,0.0,,,,,3.0,,,1.0,1.0,6.0,1.0,2.0,0.0,4.0,51.0,16.0,3.0,7.0,5.0,55.0,0.0,2.0,4.0,0.0,,0.0,1.0,,24.0,263.0,,15.0,0.0,2.0,0.0,0.0,1.0,26.0,,0.0,,1.0,0.0,2.0,1.0,,0.0,0.0
2023-11-13 00:00:00+00:00,173.0,,122.0,46.0,,271.0,,47.0,83.0,11.0,19.0,1.0,,10.0,0.0,92.0,13.0,,,6.0,0.0,2.0,8.0,30.0,1.0,,22.0,,30.0,3.0,11.0,,,62.0,5.0,,16.0,7.0,,46.0,21.0,12.0,,0.0,,6.0,0.0,9.0,1.0,,11.0,67.0,0.0,7.0,0.0,9.0,4.0,2.0,,0.0,0.0,2.0,124.0,2.0,6.0,5.0,30.0,8.0,2.0,8.0,46.0,30.0,20.0,0.0,0.0,11.0,1.0,31.0,2.0,6.0,,43.0,0.0,0.0,65.0,0.0,3.0,,,,,2.0,,,4.0,1.0,2.0,7.0,2.0,8.0,3.0,34.0,14.0,7.0,27.0,11.0,66.0,3.0,5.0,12.0,0.0,,3.0,0.0,,38.0,121.0,,12.0,0.0,0.0,3.0,0.0,0.0,2.0,,0.0,,1.0,14.0,1.0,1.0,,8.0,0.0
2023-11-14 00:00:00+00:00,172.0,,84.0,18.0,,298.0,,71.0,70.0,7.0,27.0,9.0,,3.0,0.0,81.0,12.0,,,4.0,0.0,1.0,10.0,24.0,3.0,,17.0,,13.0,2.0,6.0,,,30.0,7.0,,29.0,8.0,,29.0,22.0,20.0,,0.0,,3.0,0.0,44.0,4.0,,6.0,66.0,0.0,5.0,6.0,23.0,20.0,1.0,,0.0,0.0,1.0,31.0,5.0,5.0,3.0,38.0,2.0,2.0,4.0,60.0,27.0,21.0,3.0,0.0,1.0,1.0,41.0,1.0,0.0,,51.0,0.0,0.0,67.0,0.0,3.0,,,,,1.0,,,0.0,2.0,4.0,1.0,6.0,7.0,12.0,44.0,11.0,1.0,31.0,11.0,58.0,1.0,4.0,6.0,1.0,,1.0,0.0,,51.0,140.0,,17.0,2.0,1.0,0.0,0.0,0.0,0.0,,3.0,,8.0,3.0,2.0,2.0,,2.0,1.0
2023-11-15 00:00:00+00:00,258.0,,123.0,19.0,,328.0,,30.0,126.0,15.0,30.0,3.0,,5.0,0.0,115.0,23.0,,,5.0,0.0,2.0,10.0,22.0,2.0,,20.0,,14.0,2.0,17.0,,,23.0,11.0,,28.0,11.0,,48.0,22.0,16.0,,0.0,,5.0,6.0,29.0,9.0,,1.0,43.0,0.0,11.0,6.0,31.0,6.0,8.0,,16.0,1.0,3.0,20.0,5.0,15.0,2.0,27.0,6.0,1.0,8.0,84.0,39.0,24.0,3.0,2.0,3.0,0.0,37.0,4.0,4.0,,17.0,0.0,0.0,92.0,0.0,1.0,,,,,1.0,,,1.0,3.0,1.0,5.0,0.0,4.0,7.0,43.0,7.0,6.0,31.0,11.0,61.0,2.0,6.0,3.0,0.0,,1.0,0.0,,71.0,172.0,,14.0,0.0,2.0,3.0,0.0,0.0,2.0,,0.0,,6.0,2.0,0.0,4.0,,1.0,1.0
2023-11-16 00:00:00+00:00,151.0,,106.0,32.0,,408.0,,23.0,98.0,11.0,30.0,2.0,,7.0,0.0,162.0,21.0,,,5.0,0.0,3.0,6.0,14.0,4.0,,16.0,,4.0,0.0,50.0,,,26.0,4.0,,46.0,7.0,,17.0,22.0,23.0,,1.0,,12.0,1.0,31.0,6.0,,3.0,46.0,0.0,11.0,6.0,11.0,4.0,7.0,,5.0,2.0,4.0,36.0,4.0,11.0,2.0,29.0,9.0,2.0,6.0,179.0,38.0,16.0,1.0,1.0,2.0,1.0,88.0,4.0,1.0,,19.0,0.0,0.0,70.0,1.0,3.0,,,,,2.0,,,5.0,0.0,4.0,1.0,3.0,6.0,9.0,53.0,14.0,6.0,14.0,8.0,59.0,2.0,8.0,3.0,10.0,,3.0,0.0,,37.0,230.0,,12.0,0.0,0.0,0.0,0.0,0.0,7.0,,0.0,,9.0,2.0,2.0,5.0,,2.0,0.0
2023-11-17 00:00:00+00:00,174.0,,75.0,24.0,,299.0,,29.0,66.0,11.0,19.0,2.0,,54.0,0.0,175.0,11.0,,,1.0,0.0,3.0,11.0,15.0,6.0,,14.0,,4.0,0.0,45.0,,,32.0,5.0,,41.0,9.0,,21.0,24.0,26.0,,1.0,,7.0,2.0,37.0,4.0,,2.0,78.0,0.0,13.0,4.0,18.0,3.0,1.0,,0.0,0.0,2.0,11.0,5.0,6.0,2.0,59.0,10.0,1.0,5.0,73.0,17.0,25.0,2.0,1.0,11.0,2.0,55.0,3.0,0.0,,8.0,0.0,0.0,84.0,1.0,5.0,,,,,0.0,,,1.0,2.0,1.0,4.0,0.0,6.0,7.0,55.0,7.0,2.0,19.0,8.0,72.0,6.0,3.0,4.0,12.0,,1.0,0.0,,47.0,321.0,,21.0,0.0,5.0,0.0,0.0,0.0,2.0,,2.0,,1.0,6.0,1.0,1.0,,0.0,0.0
2023-11-18 00:00:00+00:00,118.0,,60.0,15.0,,282.0,,29.0,48.0,9.0,23.0,1.0,,39.0,0.0,110.0,10.0,,,0.0,0.0,2.0,6.0,13.0,2.0,,25.0,,4.0,0.0,126.0,,,23.0,5.0,,19.0,7.0,,13.0,40.0,16.0,,1.0,,3.0,1.0,21.0,1.0,,0.0,70.0,0.0,6.0,0.0,8.0,3.0,1.0,,0.0,7.0,13.0,11.0,12.0,3.0,1.0,31.0,1.0,1.0,3.0,76.0,24.0,22.0,1.0,1.0,0.0,2.0,33.0,2.0,0.0,,4.0,0.0,0.0,41.0,0.0,8.0,,,,,0.0,,,1.0,0.0,5.0,0.0,0.0,3.0,3.0,23.0,10.0,0.0,28.0,5.0,35.0,1.0,5.0,1.0,3.0,,0.0,0.0,,48.0,146.0,,15.0,4.0,0.0,0.0,2.0,0.0,1.0,,0.0,,0.0,2.0,5.0,2.0,,1.0,0.0
2023-11-19 00:00:00+00:00,129.0,,73.0,9.0,,288.0,,22.0,84.0,8.0,21.0,1.0,,1.0,0.0,120.0,16.0,,,0.0,0.0,4.0,7.0,6.0,1.0,,18.0,,4.0,0.0,26.0,,,33.0,4.0,,10.0,6.0,,25.0,38.0,12.0,,1.0,,3.0,2.0,28.0,1.0,,0.0,64.0,0.0,12.0,0.0,9.0,0.0,1.0,,8.0,0.0,2.0,5.0,1.0,8.0,0.0,33.0,5.0,0.0,7.0,39.0,26.0,28.0,1.0,0.0,2.0,0.0,29.0,1.0,0.0,,18.0,0.0,0.0,59.0,0.0,0.0,,,,,1.0,,,1.0,1.0,2.0,1.0,0.0,9.0,1.0,53.0,14.0,0.0,20.0,10.0,30.0,0.0,3.0,1.0,2.0,,4.0,1.0,,29.0,148.0,,14.0,3.0,0.0,1.0,0.0,0.0,1.0,,0.0,,0.0,0.0,3.0,2.0,,0.0,0.0
2023-11-20 00:00:00+00:00,157.0,,100.0,8.0,,316.0,,28.0,106.0,27.0,36.0,0.0,,7.0,0.0,99.0,26.0,,,3.0,0.0,6.0,7.0,18.0,2.0,,12.0,,20.0,3.0,24.0,,,38.0,8.0,,15.0,6.0,,89.0,19.0,21.0,,0.0,,13.0,0.0,29.0,6.0,,0.0,87.0,0.0,7.0,3.0,13.0,5.0,1.0,,17.0,2.0,2.0,14.0,5.0,3.0,9.0,23.0,15.0,2.0,12.0,44.0,24.0,19.0,5.0,0.0,0.0,0.0,37.0,8.0,0.0,,11.0,0.0,0.0,93.0,0.0,4.0,,,,,2.0,,,2.0,1.0,3.0,10.0,1.0,6.0,4.0,59.0,7.0,1.0,17.0,6.0,59.0,9.0,1.0,4.0,3.0,,3.0,1.0,,42.0,137.0,,25.0,2.0,1.0,2.0,0.0,0.0,0.0,,1.0,,6.0,1.0,2.0,4.0,,2.0,0.0
2023-11-21 00:00:00+00:00,151.0,,78.0,10.0,,420.0,,52.0,91.0,12.0,26.0,1.0,,4.0,0.0,84.0,21.0,,,3.0,1.0,0.0,5.0,25.0,2.0,,15.0,,4.0,2.0,6.0,,,25.0,5.0,,8.0,17.0,,26.0,27.0,19.0,,0.0,,5.0,1.0,36.0,9.0,,2.0,51.0,0.0,10.0,7.0,11.0,12.0,1.0,,4.0,2.0,2.0,7.0,3.0,7.0,11.0,35.0,3.0,0.0,9.0,30.0,18.0,22.0,4.0,1.0,2.0,1.0,54.0,11.0,0.0,,20.0,0.0,0.0,83.0,0.0,22.0,,,,,1.0,,,1.0,4.0,1.0,4.0,1.0,8.0,13.0,84.0,10.0,1.0,36.0,10.0,69.0,28.0,3.0,5.0,3.0,,1.0,0.0,,40.0,194.0,,27.0,0.0,2.0,0.0,0.0,0.0,0.0,,0.0,,24.0,5.0,3.0,2.0,,3.0,0.0
2023-11-22 00:00:00+00:00,159.0,,118.0,15.0,,411.0,,50.0,129.0,12.0,29.0,0.0,,13.0,0.0,119.0,17.0,,,3.0,0.0,2.0,7.0,10.0,3.0,,10.0,,7.0,6.0,6.0,,,46.0,8.0,,11.0,18.0,,44.0,57.0,29.0,,0.0,,5.0,1.0,41.0,5.0,,3.0,65.0,0.0,10.0,1.0,16.0,20.0,0.0,,1.0,1.0,3.0,10.0,4.0,6.0,6.0,44.0,8.0,4.0,6.0,51.0,32.0,19.0,3.0,0.0,9.0,0.0,36.0,4.0,0.0,,6.0,2.0,0.0,55.0,1.0,10.0,,,,,0.0,,,4.0,2.0,0.0,5.0,3.0,7.0,11.0,91.0,12.0,0.0,22.0,14.0,58.0,5.0,2.0,4.0,4.0,,2.0,0.0,,39.0,156.0,,28.0,1.0,1.0,0.0,0.0,0.0,0.0,,0.0,,7.0,3.0,1.0,1.0,,1.0,0.0
2023-11-23 00:00:00+00:00,149.0,,161.0,23.0,,347.0,,41.0,71.0,22.0,36.0,1.0,,9.0,0.0,88.0,6.0,,,0.0,0.0,3.0,28.0,21.0,3.0,,21.0,,6.0,3.0,4.0,,,24.0,10.0,,27.0,7.0,,31.0,32.0,17.0,,5.0,,11.0,3.0,42.0,1.0,,1.0,43.0,0.0,19.0,2.0,18.0,7.0,4.0,,0.0,0.0,5.0,10.0,2.0,10.0,10.0,43.0,71.0,6.0,8.0,13.0,22.0,22.0,2.0,0.0,25.0,0.0,31.0,4.0,4.0,,5.0,0.0,0.0,83.0,0.0,4.0,,,,,3.0,,,1.0,4.0,2.0,1.0,1.0,17.0,7.0,107.0,6.0,0.0,29.0,14.0,55.0,2.0,6.0,1.0,0.0,,2.0,0.0,,48.0,157.0,,17.0,4.0,0.0,5.0,1.0,0.0,2.0,,1.0,,2.0,6.0,2.0,1.0,,0.0,0.0
2023-11-24 00:00:00+00:00,130.0,,91.0,15.0,,320.0,,34.0,71.0,20.0,20.0,2.0,,10.0,0.0,76.0,18.0,,,4.0,0.0,2.0,6.0,11.0,5.0,,18.0,,9.0,4.0,2.0,,,28.0,1.0,,38.0,9.0,,33.0,36.0,4.0,,7.0,,16.0,0.0,32.0,2.0,,2.0,96.0,0.0,41.0,1.0,5.0,4.0,3.0,,1.0,1.0,29.0,3.0,6.0,4.0,5.0,38.0,13.0,2.0,3.0,23.0,25.0,23.0,1.0,2.0,4.0,0.0,22.0,2.0,3.0,,17.0,0.0,0.0,111.0,0.0,7.0,,,,,0.0,,,2.0,2.0,0.0,8.0,0.0,12.0,10.0,93.0,9.0,1.0,15.0,22.0,53.0,2.0,6.0,2.0,0.0,,4.0,0.0,,46.0,146.0,,24.0,1.0,0.0,1.0,1.0,0.0,3.0,,1.0,,3.0,3.0,6.0,2.0,,1.0,0.0
2023-11-25 00:00:00+00:00,142.0,,73.0,11.0,,267.0,,28.0,77.0,9.0,8.0,0.0,,1.0,0.0,90.0,13.0,,,4.0,0.0,2.0,13.0,7.0,1.0,,12.0,,5.0,7.0,2.0,,,46.0,1.0,,6.0,12.0,,19.0,38.0,10.0,,7.0,,3.0,3.0,33.0,2.0,,2.0,75.0,0.0,29.0,2.0,12.0,3.0,0.0,,2.0,0.0,4.0,7.0,3.0,7.0,3.0,54.0,6.0,1.0,10.0,13.0,13.0,16.0,1.0,2.0,5.0,1.0,25.0,1.0,1.0,,8.0,0.0,0.0,103.0,1.0,2.0,,,,,0.0,,,0.0,8.0,0.0,1.0,0.0,2.0,4.0,54.0,10.0,0.0,23.0,10.0,42.0,1.0,3.0,3.0,2.0,,2.0,0.0,,48.0,112.0,,14.0,3.0,0.0,0.0,0.0,0.0,0.0,,0.0,,1.0,5.0,2.0,1.0,,0.0,0.0
2023-11-26 00:00:00+00:00,148.0,,52.0,8.0,,358.0,,16.0,77.0,10.0,29.0,2.0,,7.0,0.0,72.0,19.0,,,1.0,0.0,3.0,9.0,13.0,0.0,,11.0,,0.0,3.0,1.0,,,29.0,1.0,,8.0,13.0,,33.0,38.0,17.0,,2.0,,9.0,0.0,26.0,2.0,,4.0,67.0,0.0,19.0,0.0,4.0,4.0,15.0,,1.0,2.0,3.0,3.0,1.0,4.0,5.0,38.0,3.0,2.0,5.0,24.0,19.0,36.0,3.0,0.0,0.0,0.0,28.0,1.0,0.0,,2.0,0.0,0.0,84.0,1.0,3.0,,,,,2.0,,,2.0,3.0,4.0,0.0,0.0,3.0,1.0,45.0,7.0,1.0,21.0,12.0,48.0,2.0,2.0,5.0,1.0,,1.0,0.0,,57.0,148.0,,6.0,1.0,0.0,0.0,2.0,0.0,1.0,,0.0,,0.0,2.0,1.0,0.0,,2.0,1.0
2023-11-27 00:00:00+00:00,153.0,,57.0,7.0,,323.0,,34.0,82.0,8.0,21.0,0.0,,7.0,0.0,61.0,12.0,,,2.0,0.0,2.0,25.0,26.0,1.0,,8.0,,8.0,5.0,1.0,,,18.0,3.0,,6.0,5.0,,27.0,21.0,9.0,,0.0,,9.0,0.0,34.0,4.0,,1.0,40.0,0.0,16.0,2.0,14.0,10.0,4.0,,1.0,1.0,5.0,3.0,3.0,4.0,4.0,45.0,7.0,1.0,5.0,52.0,26.0,33.0,1.0,1.0,3.0,0.0,26.0,8.0,1.0,,7.0,1.0,0.0,96.0,2.0,5.0,,,,,6.0,,,1.0,1.0,0.0,1.0,2.0,4.0,8.0,62.0,7.0,1.0,12.0,13.0,75.0,1.0,3.0,3.0,5.0,,1.0,0.0,,67.0,176.0,,13.0,1.0,1.0,3.0,0.0,0.0,0.0,,0.0,,2.0,3.0,1.0,1.0,,1.0,0.0
2023-11-28 00:00:00+00:00,202.0,,52.0,3.0,,279.0,,35.0,47.0,3.0,30.0,1.0,,2.0,0.0,70.0,12.0,,,3.0,0.0,5.0,22.0,13.0,1.0,,16.0,,2.0,1.0,4.0,,,41.0,15.0,,9.0,7.0,,30.0,72.0,21.0,,2.0,,11.0,0.0,35.0,2.0,,4.0,45.0,0.0,5.0,1.0,16.0,1.0,3.0,,0.0,0.0,4.0,20.0,2.0,5.0,6.0,36.0,9.0,0.0,3.0,29.0,21.0,17.0,1.0,0.0,0.0,0.0,31.0,3.0,0.0,,3.0,0.0,0.0,91.0,0.0,8.0,,,,,1.0,,,4.0,3.0,1.0,1.0,0.0,1.0,1.0,57.0,9.0,1.0,32.0,8.0,39.0,3.0,4.0,3.0,2.0,,1.0,0.0,,56.0,139.0,,19.0,2.0,0.0,1.0,2.0,1.0,0.0,,0.0,,2.0,0.0,4.0,2.0,,0.0,0.0
2023-11-29 00:00:00+00:00,181.0,,84.0,15.0,,311.0,,26.0,84.0,44.0,30.0,1.0,,6.0,0.0,66.0,13.0,,,8.0,0.0,1.0,12.0,16.0,3.0,,13.0,,3.0,5.0,4.0,,,24.0,6.0,,9.0,10.0,,37.0,27.0,13.0,,0.0,,20.0,0.0,39.0,2.0,,3.0,81.0,0.0,17.0,5.0,20.0,1.0,6.0,,0.0,2.0,3.0,6.0,7.0,6.0,8.0,44.0,10.0,8.0,6.0,33.0,31.0,17.0,2.0,2.0,5.0,0.0,41.0,1.0,2.0,,4.0,0.0,0.0,102.0,0.0,6.0,,,,,1.0,,,1.0,7.0,1.0,4.0,0.0,1.0,7.0,51.0,6.0,0.0,22.0,10.0,104.0,2.0,1.0,2.0,0.0,,5.0,1.0,,90.0,189.0,,24.0,1.0,0.0,0.0,2.0,1.0,0.0,,0.0,,5.0,1.0,0.0,1.0,,1.0,0.0
2023-11-30 00:00:00+00:00,181.0,,71.0,6.0,,304.0,,38.0,107.0,41.0,16.0,2.0,,5.0,1.0,51.0,18.0,,,10.0,0.0,3.0,11.0,6.0,2.0,,6.0,,3.0,2.0,3.0,,,22.0,4.0,,6.0,7.0,,32.0,21.0,24.0,,0.0,,8.0,2.0,37.0,2.0,,1.0,75.0,0.0,13.0,1.0,19.0,1.0,2.0,,2.0,2.0,0.0,3.0,4.0,6.0,5.0,26.0,1.0,7.0,5.0,32.0,11.0,20.0,1.0,0.0,6.0,0.0,29.0,2.0,1.0,,2.0,0.0,0.0,88.0,0.0,4.0,,,,,1.0,,,4.0,3.0,0.0,0.0,2.0,2.0,6.0,35.0,4.0,0.0,25.0,9.0,55.0,4.0,0.0,3.0,7.0,,1.0,1.0,,61.0,142.0,,19.0,3.0,0.0,3.0,1.0,0.0,0.0,,0.0,,6.0,0.0,6.0,0.0,,1.0,0.0
2023-12-01 00:00:00+00:00,167.0,,66.0,5.0,,333.0,,35.0,55.0,18.0,29.0,2.0,,2.0,0.0,33.0,18.0,,,9.0,0.0,4.0,12.0,46.0,3.0,,11.0,,16.0,10.0,5.0,,,17.0,3.0,,17.0,11.0,,33.0,32.0,21.0,,3.0,,9.0,3.0,37.0,2.0,,1.0,126.0,0.0,9.0,2.0,18.0,7.0,5.0,,1.0,3.0,2.0,8.0,11.0,10.0,6.0,31.0,6.0,4.0,7.0,49.0,27.0,16.0,3.0,1.0,5.0,0.0,38.0,4.0,4.0,,3.0,0.0,1.0,91.0,1.0,3.0,,,,,2.0,,,0.0,3.0,1.0,4.0,1.0,2.0,9.0,52.0,8.0,4.0,34.0,8.0,64.0,7.0,1.0,4.0,9.0,,4.0,0.0,,63.0,173.0,,17.0,0.0,0.0,2.0,0.0,0.0,5.0,,0.0,,7.0,3.0,8.0,5.0,,0.0,1.0
2023-12-02 00:00:00+00:00,151.0,,59.0,5.0,,301.0,,21.0,70.0,1.0,35.0,0.0,,1.0,1.0,62.0,6.0,,,2.0,0.0,2.0,3.0,16.0,1.0,,12.0,,1.0,4.0,2.0,,,19.0,10.0,,21.0,7.0,,46.0,41.0,17.0,,1.0,,6.0,5.0,33.0,0.0,,2.0,77.0,0.0,8.0,5.0,18.0,2.0,3.0,,0.0,1.0,0.0,9.0,5.0,11.0,6.0,27.0,4.0,1.0,1.0,24.0,24.0,16.0,3.0,1.0,2.0,1.0,51.0,2.0,1.0,,9.0,0.0,0.0,50.0,3.0,4.0,,,,,1.0,,,1.0,4.0,5.0,9.0,0.0,2.0,8.0,38.0,5.0,10.0,15.0,4.0,48.0,2.0,9.0,2.0,0.0,,5.0,0.0,,49.0,143.0,,10.0,3.0,0.0,0.0,0.0,0.0,0.0,,0.0,,1.0,3.0,0.0,2.0,,4.0,0.0
2023-12-03 00:00:00+00:00,155.0,,66.0,5.0,,308.0,,19.0,79.0,0.0,21.0,0.0,,1.0,0.0,44.0,8.0,,,2.0,0.0,3.0,8.0,9.0,2.0,,8.0,,2.0,0.0,3.0,,,12.0,10.0,,2.0,8.0,,27.0,26.0,17.0,,0.0,,6.0,2.0,28.0,4.0,,0.0,64.0,0.0,15.0,3.0,4.0,2.0,8.0,,0.0,2.0,6.0,2.0,5.0,3.0,3.0,18.0,4.0,0.0,7.0,19.0,14.0,18.0,1.0,0.0,4.0,0.0,27.0,1.0,0.0,,7.0,0.0,0.0,87.0,0.0,3.0,,,,,1.0,,,4.0,0.0,1.0,11.0,1.0,2.0,7.0,35.0,5.0,3.0,16.0,10.0,66.0,3.0,7.0,3.0,0.0,,6.0,0.0,,44.0,142.0,,17.0,4.0,0.0,0.0,1.0,0.0,0.0,,0.0,,8.0,6.0,2.0,2.0,,5.0,0.0
2023-12-04 00:00:00+00:00,142.0,,69.0,9.0,,322.0,,33.0,68.0,6.0,37.0,2.0,,6.0,0.0,40.0,23.0,,,2.0,0.0,3.0,4.0,22.0,5.0,,16.0,,13.0,11.0,8.0,,,39.0,7.0,,4.0,4.0,,74.0,34.0,25.0,,3.0,,3.0,1.0,37.0,2.0,,3.0,113.0,1.0,10.0,4.0,6.0,1.0,5.0,,0.0,2.0,1.0,4.0,4.0,5.0,9.0,33.0,9.0,1.0,12.0,20.0,14.0,23.0,0.0,0.0,2.0,0.0,26.0,0.0,0.0,,43.0,0.0,0.0,111.0,1.0,0.0,,,,,2.0,,,2.0,7.0,3.0,6.0,1.0,5.0,5.0,67.0,12.0,0.0,14.0,9.0,59.0,3.0,7.0,5.0,0.0,,5.0,2.0,,44.0,214.0,,13.0,0.0,0.0,0.0,2.0,3.0,0.0,,0.0,,2.0,5.0,2.0,4.0,,7.0,0.0
2023-12-05 00:00:00+00:00,152.0,,82.0,10.0,,325.0,,25.0,73.0,4.0,29.0,4.0,,13.0,0.0,17.0,18.0,,,3.0,0.0,2.0,13.0,31.0,5.0,,4.0,,16.0,4.0,4.0,,,32.0,13.0,,11.0,10.0,,43.0,31.0,16.0,,2.0,,10.0,0.0,31.0,5.0,,0.0,86.0,0.0,8.0,8.0,16.0,1.0,3.0,,0.0,0.0,4.0,10.0,8.0,11.0,9.0,49.0,7.0,7.0,4.0,11.0,22.0,19.0,2.0,0.0,8.0,0.0,37.0,1.0,0.0,,4.0,0.0,0.0,75.0,0.0,3.0,,,,,3.0,,,1.0,7.0,2.0,4.0,0.0,2.0,6.0,54.0,8.0,0.0,28.0,13.0,61.0,5.0,5.0,0.0,1.0,,0.0,0.0,,31.0,298.0,,18.0,2.0,0.0,0.0,1.0,2.0,1.0,,0.0,,4.0,8.0,0.0,2.0,,1.0,0.0
2023-12-06 00:00:00+00:00,186.0,,89.0,12.0,,390.0,,27.0,61.0,9.0,32.0,1.0,,7.0,0.0,42.0,10.0,,,5.0,0.0,4.0,8.0,17.0,5.0,,11.0,,4.0,3.0,3.0,,,24.0,13.0,,11.0,5.0,,29.0,26.0,31.0,,2.0,,7.0,2.0,34.0,24.0,,2.0,78.0,0.0,12.0,4.0,10.0,4.0,2.0,,0.0,2.0,0.0,38.0,8.0,5.0,7.0,49.0,10.0,8.0,9.0,13.0,13.0,30.0,0.0,1.0,2.0,0.0,39.0,2.0,1.0,,32.0,0.0,0.0,105.0,0.0,1.0,,,,,3.0,,,3.0,5.0,1.0,7.0,0.0,2.0,5.0,80.0,8.0,1.0,39.0,19.0,57.0,10.0,21.0,4.0,19.0,,7.0,0.0,0.0,27.0,186.0,,26.0,2.0,1.0,0.0,0.0,2.0,0.0,,1.0,,18.0,3.0,3.0,5.0,,2.0,0.0
2023-12-07 00:00:00+00:00,278.0,,81.0,7.0,,388.0,,25.0,74.0,11.0,38.0,0.0,,6.0,0.0,42.0,3.0,,,3.0,1.0,1.0,6.0,20.0,2.0,,12.0,,5.0,14.0,3.0,,,15.0,5.0,,7.0,3.0,,52.0,26.0,24.0,,1.0,,4.0,1.0,29.0,10.0,,3.0,100.0,0.0,21.0,1.0,21.0,5.0,8.0,,0.0,0.0,5.0,18.0,4.0,4.0,8.0,40.0,2.0,4.0,4.0,9.0,15.0,30.0,3.0,1.0,4.0,1.0,28.0,1.0,1.0,,18.0,0.0,0.0,80.0,0.0,4.0,,,,,1.0,,,2.0,3.0,1.0,7.0,0.0,6.0,7.0,55.0,7.0,3.0,32.0,14.0,53.0,2.0,79.0,2.0,12.0,,2.0,1.0,1.0,44.0,177.0,,29.0,1.0,2.0,1.0,1.0,0.0,0.0,,0.0,,14.0,30.0,3.0,2.0,,0.0,0.0
2023-12-08 00:00:00+00:00,307.0,,96.0,9.0,,355.0,,35.0,158.0,6.0,35.0,7.0,,7.0,0.0,40.0,19.0,,,2.0,0.0,5.0,8.0,25.0,2.0,,15.0,,10.0,2.0,10.0,,,26.0,9.0,,7.0,6.0,,51.0,27.0,17.0,,2.0,,7.0,0.0,31.0,8.0,,4.0,56.0,0.0,14.0,3.0,21.0,5.0,4.0,,3.0,5.0,3.0,7.0,5.0,4.0,2.0,49.0,4.0,1.0,5.0,24.0,9.0,27.0,2.0,2.0,2.0,0.0,69.0,1.0,1.0,,23.0,0.0,0.0,95.0,2.0,2.0,,,,,0.0,,,1.0,3.0,3.0,7.0,3.0,3.0,10.0,81.0,10.0,0.0,28.0,11.0,64.0,6.0,45.0,1.0,1.0,,5.0,0.0,3.0,33.0,179.0,,36.0,1.0,1.0,1.0,0.0,0.0,0.0,,4.0,,0.0,2.0,2.0,1.0,,1.0,0.0
2023-12-09 00:00:00+00:00,190.0,,77.0,12.0,,321.0,,37.0,150.0,3.0,50.0,0.0,,6.0,0.0,24.0,10.0,,,1.0,0.0,3.0,9.0,23.0,5.0,,9.0,,12.0,0.0,3.0,,,41.0,4.0,,6.0,7.0,,52.0,46.0,22.0,,2.0,,5.0,1.0,19.0,4.0,,2.0,64.0,0.0,13.0,2.0,20.0,3.0,0.0,,1.0,8.0,1.0,21.0,5.0,7.0,7.0,27.0,3.0,0.0,7.0,8.0,15.0,14.0,0.0,0.0,1.0,0.0,41.0,1.0,4.0,,21.0,0.0,0.0,84.0,2.0,3.0,,,,,1.0,,,5.0,1.0,2.0,1.0,0.0,4.0,10.0,53.0,11.0,0.0,36.0,16.0,55.0,2.0,3.0,3.0,1.0,,3.0,0.0,2.0,28.0,138.0,,21.0,1.0,1.0,1.0,2.0,0.0,0.0,,0.0,,0.0,0.0,1.0,2.0,,0.0,0.0
2023-12-10 00:00:00+00:00,158.0,,76.0,13.0,,672.0,,29.0,179.0,3.0,43.0,2.0,,1.0,0.0,60.0,8.0,,,1.0,0.0,1.0,6.0,20.0,4.0,,8.0,,3.0,1.0,1.0,,,38.0,3.0,,8.0,8.0,,21.0,37.0,20.0,,0.0,,6.0,2.0,22.0,8.0,,9.0,49.0,0.0,17.0,0.0,1.0,3.0,3.0,,0.0,0.0,2.0,12.0,1.0,5.0,1.0,25.0,3.0,1.0,4.0,6.0,12.0,31.0,0.0,0.0,4.0,0.0,26.0,2.0,3.0,,30.0,0.0,0.0,84.0,0.0,7.0,,,,,1.0,,,0.0,3.0,0.0,0.0,0.0,2.0,5.0,55.0,10.0,2.0,29.0,5.0,53.0,5.0,6.0,5.0,0.0,,2.0,0.0,0.0,33.0,213.0,,21.0,3.0,0.0,2.0,0.0,0.0,1.0,,0.0,,4.0,1.0,0.0,1.0,,4.0,0.0
2023-12-11 00:00:00+00:00,223.0,,98.0,11.0,,427.0,,39.0,491.0,5.0,30.0,1.0,,4.0,0.0,60.0,9.0,,,4.0,0.0,0.0,6.0,14.0,5.0,,13.0,,4.0,7.0,0.0,,,47.0,5.0,,4.0,25.0,,26.0,29.0,26.0,,1.0,,7.0,1.0,32.0,10.0,,0.0,81.0,0.0,10.0,1.0,15.0,10.0,5.0,,0.0,1.0,3.0,13.0,7.0,6.0,1.0,38.0,4.0,1.0,4.0,10.0,41.0,25.0,1.0,0.0,4.0,0.0,55.0,2.0,0.0,,17.0,0.0,0.0,91.0,0.0,10.0,,,,,3.0,,,2.0,2.0,2.0,2.0,0.0,2.0,9.0,59.0,6.0,1.0,12.0,8.0,83.0,3.0,1.0,6.0,2.0,,7.0,0.0,3.0,57.0,237.0,,22.0,5.0,0.0,0.0,0.0,0.0,1.0,,0.0,,8.0,4.0,5.0,0.0,,2.0,1.0
2023-12-12 00:00:00+00:00,268.0,,91.0,14.0,,544.0,,52.0,721.0,6.0,31.0,3.0,,9.0,0.0,52.0,6.0,,,2.0,0.0,3.0,25.0,18.0,4.0,,8.0,,28.0,5.0,2.0,,,119.0,4.0,,11.0,45.0,,21.0,20.0,31.0,,3.0,,2.0,1.0,37.0,5.0,,13.0,49.0,0.0,9.0,12.0,11.0,10.0,2.0,,0.0,1.0,11.0,10.0,12.0,7.0,1.0,51.0,4.0,4.0,8.0,16.0,94.0,23.0,0.0,1.0,4.0,0.0,38.0,5.0,3.0,,23.0,0.0,0.0,88.0,1.0,5.0,,,,,1.0,,,5.0,6.0,7.0,2.0,7.0,8.0,12.0,70.0,12.0,2.0,33.0,4.0,69.0,1.0,28.0,4.0,9.0,,3.0,0.0,1.0,65.0,199.0,,36.0,4.0,2.0,5.0,2.0,1.0,1.0,,1.0,,1.0,2.0,1.0,2.0,,4.0,0.0
2023-12-13 00:00:00+00:00,257.0,,100.0,19.0,,513.0,,44.0,321.0,5.0,30.0,2.0,,5.0,0.0,77.0,18.0,,,2.0,0.0,11.0,6.0,14.0,2.0,,10.0,,3.0,2.0,14.0,,,57.0,10.0,,6.0,18.0,,26.0,26.0,55.0,,2.0,,2.0,1.0,40.0,1.0,,7.0,91.0,0.0,15.0,1.0,15.0,3.0,3.0,,0.0,2.0,13.0,9.0,23.0,9.0,3.0,45.0,2.0,4.0,8.0,7.0,36.0,23.0,0.0,0.0,2.0,2.0,40.0,9.0,3.0,,14.0,0.0,0.0,64.0,0.0,10.0,,,,,2.0,,,1.0,4.0,1.0,4.0,2.0,8.0,9.0,67.0,9.0,11.0,25.0,13.0,98.0,0.0,9.0,5.0,4.0,,6.0,0.0,1.0,44.0,196.0,,36.0,4.0,1.0,1.0,0.0,0.0,1.0,,0.0,,1.0,2.0,2.0,3.0,,9.0,0.0
2023-12-14 00:00:00+00:00,297.0,,127.0,21.0,,532.0,,43.0,506.0,4.0,59.0,2.0,,5.0,0.0,58.0,12.0,,,4.0,0.0,2.0,12.0,25.0,2.0,,13.0,,11.0,3.0,10.0,,,67.0,10.0,,56.0,13.0,,17.0,24.0,34.0,,4.0,,5.0,4.0,35.0,7.0,,0.0,81.0,0.0,19.0,1.0,27.0,4.0,5.0,,1.0,19.0,1.0,9.0,13.0,14.0,9.0,54.0,1.0,1.0,6.0,18.0,74.0,31.0,0.0,0.0,1.0,0.0,60.0,3.0,1.0,,8.0,0.0,0.0,91.0,2.0,8.0,,,,,3.0,,,2.0,2.0,2.0,1.0,0.0,2.0,9.0,70.0,9.0,0.0,30.0,19.0,81.0,2.0,13.0,3.0,9.0,,7.0,1.0,2.0,51.0,224.0,,22.0,1.0,4.0,2.0,1.0,0.0,0.0,,0.0,,3.0,3.0,2.0,1.0,,2.0,0.0
2023-12-15 00:00:00+00:00,237.0,,121.0,39.0,,455.0,,46.0,328.0,9.0,72.0,1.0,,7.0,0.0,25.0,17.0,,,4.0,0.0,3.0,6.0,12.0,2.0,,6.0,,4.0,2.0,5.0,,,94.0,8.0,,19.0,18.0,,13.0,29.0,27.0,,0.0,,4.0,3.0,39.0,5.0,,2.0,80.0,0.0,16.0,7.0,11.0,3.0,1.0,,1.0,2.0,2.0,10.0,6.0,8.0,2.0,31.0,3.0,3.0,7.0,11.0,35.0,22.0,0.0,1.0,1.0,5.0,40.0,2.0,3.0,,19.0,0.0,0.0,98.0,1.0,12.0,,,,,4.0,,,2.0,1.0,7.0,3.0,1.0,11.0,4.0,54.0,9.0,3.0,30.0,14.0,76.0,4.0,3.0,5.0,20.0,,6.0,0.0,0.0,55.0,214.0,,21.0,2.0,1.0,1.0,0.0,0.0,0.0,,0.0,,6.0,4.0,3.0,1.0,,4.0,0.0
2023-12-16 00:00:00+00:00,267.0,,81.0,13.0,,491.0,,34.0,293.0,1.0,66.0,0.0,,0.0,0.0,31.0,14.0,,,0.0,0.0,2.0,8.0,10.0,5.0,,11.0,,3.0,3.0,3.0,,,70.0,1.0,,6.0,13.0,,27.0,33.0,19.0,,4.0,,2.0,4.0,15.0,0.0,,2.0,59.0,0.0,9.0,1.0,46.0,8.0,1.0,,1.0,3.0,1.0,18.0,4.0,6.0,4.0,27.0,1.0,1.0,3.0,16.0,16.0,30.0,1.0,1.0,3.0,0.0,53.0,2.0,2.0,,22.0,0.0,0.0,97.0,0.0,6.0,,,,,0.0,,,1.0,6.0,4.0,1.0,1.0,27.0,2.0,61.0,11.0,2.0,25.0,3.0,60.0,5.0,6.0,3.0,7.0,,7.0,0.0,0.0,40.0,182.0,,25.0,0.0,2.0,1.0,2.0,0.0,1.0,,0.0,,1.0,0.0,3.0,4.0,,1.0,0.0
2023-12-17 00:00:00+00:00,244.0,,96.0,3.0,,440.0,,40.0,467.0,3.0,81.0,0.0,,8.0,2.0,35.0,10.0,,,0.0,0.0,4.0,5.0,13.0,3.0,,5.0,,6.0,3.0,0.0,,,50.0,1.0,,10.0,8.0,,40.0,43.0,18.0,,0.0,,12.0,1.0,18.0,3.0,,2.0,57.0,0.0,11.0,0.0,3.0,3.0,1.0,,19.0,2.0,1.0,14.0,5.0,6.0,6.0,50.0,1.0,1.0,2.0,12.0,26.0,24.0,2.0,0.0,5.0,1.0,49.0,2.0,0.0,,22.0,0.0,0.0,84.0,0.0,13.0,,,,,7.0,,,0.0,1.0,1.0,1.0,1.0,18.0,3.0,57.0,4.0,0.0,15.0,6.0,57.0,7.0,1.0,2.0,4.0,,4.0,0.0,1.0,70.0,155.0,,19.0,0.0,2.0,3.0,0.0,0.0,0.0,,0.0,,2.0,0.0,1.0,2.0,,1.0,0.0
2023-12-18 00:00:00+00:00,201.0,,80.0,13.0,,483.0,,29.0,727.0,11.0,76.0,0.0,,6.0,0.0,29.0,4.0,,,1.0,0.0,2.0,13.0,12.0,1.0,,28.0,,7.0,5.0,1.0,,,59.0,12.0,,9.0,10.0,,46.0,3.0,21.0,,4.0,,4.0,5.0,31.0,14.0,,2.0,64.0,0.0,16.0,3.0,16.0,4.0,2.0,,0.0,1.0,1.0,8.0,4.0,6.0,12.0,47.0,0.0,2.0,6.0,20.0,22.0,27.0,1.0,0.0,3.0,0.0,44.0,4.0,1.0,,26.0,0.0,0.0,121.0,1.0,3.0,,,,,2.0,,,1.0,2.0,8.0,2.0,5.0,17.0,11.0,60.0,6.0,2.0,17.0,18.0,90.0,7.0,4.0,3.0,16.0,,12.0,1.0,1.0,30.0,193.0,,23.0,5.0,0.0,5.0,0.0,1.0,0.0,,1.0,,3.0,1.0,5.0,3.0,,7.0,0.0
2023-12-19 00:00:00+00:00,153.0,,103.0,15.0,,462.0,,32.0,989.0,3.0,76.0,0.0,,5.0,0.0,26.0,15.0,,,6.0,0.0,2.0,15.0,21.0,3.0,,16.0,,2.0,10.0,4.0,,,82.0,4.0,,9.0,15.0,,26.0,22.0,20.0,,6.0,,9.0,4.0,28.0,3.0,,6.0,70.0,0.0,8.0,3.0,45.0,2.0,9.0,,0.0,0.0,1.0,9.0,4.0,10.0,8.0,58.0,2.0,1.0,6.0,9.0,25.0,35.0,0.0,0.0,2.0,0.0,66.0,4.0,4.0,,57.0,0.0,1.0,126.0,1.0,6.0,,,,,0.0,,,6.0,1.0,4.0,1.0,5.0,11.0,11.0,66.0,5.0,1.0,30.0,10.0,64.0,3.0,2.0,2.0,2.0,,5.0,1.0,1.0,54.0,206.0,,34.0,3.0,11.0,1.0,0.0,1.0,1.0,,0.0,,7.0,1.0,2.0,0.0,,11.0,0.0
2023-12-20 00:00:00+00:00,164.0,,103.0,15.0,,538.0,,39.0,744.0,0.0,102.0,0.0,,3.0,0.0,32.0,11.0,,,3.0,0.0,3.0,19.0,23.0,4.0,,8.0,,5.0,2.0,1.0,,,91.0,5.0,,8.0,4.0,,7.0,22.0,26.0,,2.0,,7.0,1.0,41.0,1.0,,6.0,57.0,0.0,19.0,4.0,36.0,6.0,5.0,,2.0,1.0,0.0,16.0,7.0,8.0,8.0,119.0,0.0,6.0,5.0,9.0,24.0,52.0,3.0,1.0,3.0,1.0,52.0,2.0,11.0,,21.0,0.0,0.0,111.0,2.0,8.0,,,,,1.0,,,6.0,3.0,4.0,0.0,4.0,9.0,9.0,83.0,6.0,1.0,23.0,12.0,91.0,10.0,5.0,2.0,4.0,,10.0,0.0,0.0,53.0,186.0,,30.0,0.0,9.0,2.0,0.0,0.0,0.0,,0.0,,4.0,2.0,7.0,3.0,,4.0,0.0
2023-12-21 00:00:00+00:00,155.0,,108.0,8.0,,486.0,,37.0,643.0,1.0,182.0,1.0,,5.0,0.0,32.0,14.0,,,1.0,0.0,5.0,19.0,23.0,5.0,,12.0,,11.0,6.0,10.0,,,91.0,8.0,,10.0,11.0,,13.0,23.0,21.0,,7.0,,9.0,4.0,28.0,1.0,,3.0,67.0,0.0,23.0,1.0,30.0,3.0,0.0,,0.0,5.0,2.0,6.0,4.0,2.0,8.0,73.0,2.0,7.0,9.0,5.0,21.0,46.0,1.0,0.0,4.0,1.0,36.0,4.0,3.0,,15.0,0.0,0.0,117.0,0.0,1.0,,,,,6.0,,,0.0,2.0,2.0,2.0,1.0,3.0,22.0,115.0,5.0,2.0,27.0,23.0,76.0,3.0,6.0,0.0,7.0,,12.0,0.0,0.0,78.0,230.0,,21.0,0.0,1.0,0.0,0.0,0.0,0.0,,0.0,,3.0,3.0,2.0,2.0,,4.0,1.0
2023-12-22 00:00:00+00:00,153.0,,92.0,8.0,,550.0,,32.0,367.0,12.0,195.0,0.0,24.0,5.0,0.0,40.0,21.0,,,1.0,0.0,10.0,11.0,24.0,5.0,,8.0,,8.0,8.0,3.0,,,52.0,6.0,,1.0,18.0,,27.0,22.0,23.0,,5.0,,8.0,0.0,29.0,1.0,,6.0,80.0,0.0,11.0,2.0,55.0,3.0,0.0,,1.0,22.0,4.0,6.0,3.0,9.0,7.0,49.0,2.0,5.0,6.0,39.0,17.0,29.0,3.0,0.0,5.0,0.0,43.0,1.0,1.0,,9.0,0.0,0.0,78.0,0.0,4.0,,,,,1.0,,,2.0,0.0,1.0,0.0,3.0,3.0,10.0,78.0,8.0,3.0,17.0,11.0,73.0,2.0,3.0,6.0,2.0,,5.0,0.0,1.0,83.0,182.0,,8.0,0.0,0.0,3.0,0.0,0.0,0.0,,5.0,,0.0,1.0,3.0,2.0,,3.0,0.0
2023-12-23 00:00:00+00:00,98.0,,82.0,3.0,,420.0,,38.0,489.0,8.0,166.0,3.0,31.0,4.0,0.0,35.0,3.0,,,1.0,0.0,3.0,15.0,14.0,3.0,,12.0,,19.0,4.0,0.0,,,50.0,4.0,,6.0,13.0,,15.0,37.0,17.0,,3.0,,19.0,3.0,25.0,1.0,,0.0,83.0,0.0,11.0,0.0,21.0,3.0,6.0,,2.0,4.0,1.0,7.0,5.0,2.0,20.0,35.0,1.0,3.0,4.0,13.0,14.0,35.0,2.0,2.0,2.0,0.0,50.0,5.0,0.0,,9.0,0.0,0.0,98.0,0.0,6.0,,,,,1.0,,,3.0,0.0,2.0,1.0,3.0,5.0,28.0,75.0,10.0,3.0,13.0,10.0,60.0,6.0,3.0,2.0,1.0,,6.0,1.0,2.0,80.0,188.0,,16.0,1.0,0.0,2.0,0.0,0.0,0.0,,5.0,,4.0,0.0,0.0,2.0,,2.0,0.0
2023-12-24 00:00:00+00:00,83.0,,78.0,20.0,,430.0,,23.0,369.0,6.0,150.0,1.0,23.0,4.0,0.0,29.0,12.0,,,0.0,0.0,2.0,10.0,12.0,2.0,,8.0,,9.0,4.0,2.0,,,32.0,1.0,,5.0,9.0,,29.0,42.0,18.0,,4.0,,3.0,3.0,17.0,5.0,,4.0,81.0,0.0,20.0,0.0,9.0,1.0,4.0,,1.0,3.0,0.0,12.0,4.0,3.0,7.0,30.0,2.0,4.0,7.0,29.0,19.0,22.0,0.0,0.0,1.0,0.0,39.0,16.0,3.0,,12.0,0.0,0.0,46.0,0.0,1.0,,,,,1.0,,,3.0,1.0,1.0,2.0,1.0,2.0,10.0,79.0,9.0,13.0,22.0,11.0,57.0,2.0,3.0,1.0,1.0,,4.0,0.0,2.0,61.0,139.0,,16.0,1.0,1.0,1.0,1.0,0.0,0.0,,1.0,,1.0,0.0,1.0,1.0,,0.0,0.0
2023-12-25 00:00:00+00:00,96.0,,78.0,10.0,,405.0,,21.0,276.0,14.0,142.0,5.0,19.0,3.0,0.0,39.0,24.0,,,2.0,0.0,1.0,15.0,11.0,4.0,,9.0,,6.0,0.0,7.0,,,35.0,7.0,,8.0,5.0,,20.0,19.0,13.0,,0.0,,1.0,2.0,14.0,7.0,,0.0,44.0,2.0,12.0,2.0,18.0,4.0,2.0,,0.0,7.0,0.0,3.0,11.0,2.0,8.0,30.0,0.0,1.0,2.0,14.0,16.0,17.0,1.0,0.0,3.0,0.0,28.0,14.0,1.0,,13.0,0.0,0.0,68.0,1.0,1.0,,,,,2.0,,,0.0,4.0,1.0,2.0,2.0,2.0,28.0,59.0,8.0,6.0,25.0,5.0,39.0,1.0,2.0,2.0,1.0,,11.0,0.0,1.0,39.0,158.0,,17.0,2.0,0.0,1.0,0.0,0.0,0.0,,1.0,,0.0,2.0,0.0,2.0,,1.0,0.0
2023-12-26 00:00:00+00:00,91.0,,83.0,24.0,,407.0,,23.0,261.0,4.0,136.0,2.0,38.0,4.0,0.0,43.0,66.0,,,5.0,0.0,1.0,6.0,9.0,6.0,,12.0,,13.0,3.0,0.0,,,110.0,4.0,,11.0,7.0,,54.0,29.0,15.0,,4.0,,6.0,1.0,13.0,15.0,,0.0,94.0,0.0,22.0,0.0,24.0,6.0,1.0,,0.0,1.0,1.0,14.0,10.0,10.0,12.0,36.0,1.0,4.0,8.0,47.0,27.0,25.0,3.0,0.0,3.0,1.0,42.0,6.0,0.0,,19.0,0.0,0.0,93.0,1.0,6.0,,,,,0.0,,,1.0,1.0,4.0,1.0,1.0,7.0,27.0,74.0,9.0,1.0,26.0,51.0,97.0,3.0,10.0,2.0,5.0,,24.0,1.0,0.0,69.0,184.0,,15.0,0.0,2.0,2.0,0.0,0.0,1.0,,1.0,,1.0,0.0,5.0,0.0,,3.0,0.0
2023-12-27 00:00:00+00:00,168.0,,80.0,13.0,,450.0,,33.0,234.0,9.0,134.0,3.0,43.0,1.0,0.0,38.0,21.0,,,2.0,0.0,3.0,7.0,16.0,6.0,,7.0,,18.0,3.0,0.0,,,62.0,10.0,,10.0,15.0,,39.0,27.0,15.0,,2.0,,16.0,2.0,37.0,3.0,,0.0,100.0,0.0,21.0,2.0,30.0,3.0,3.0,,3.0,2.0,8.0,6.0,6.0,8.0,7.0,45.0,1.0,4.0,7.0,17.0,13.0,34.0,9.0,4.0,1.0,0.0,43.0,14.0,1.0,,33.0,0.0,0.0,93.0,0.0,2.0,,,,,0.0,,,6.0,3.0,0.0,1.0,2.0,5.0,36.0,69.0,6.0,0.0,35.0,32.0,66.0,4.0,1.0,3.0,9.0,,18.0,1.0,0.0,122.0,221.0,,19.0,4.0,0.0,2.0,0.0,0.0,0.0,,0.0,,4.0,0.0,0.0,0.0,,1.0,0.0
2023-12-28 00:00:00+00:00,212.0,,96.0,34.0,,496.0,,35.0,226.0,15.0,95.0,1.0,29.0,8.0,0.0,26.0,11.0,,,6.0,0.0,3.0,6.0,12.0,2.0,,12.0,,19.0,1.0,1.0,,,59.0,6.0,,12.0,10.0,,46.0,24.0,35.0,,1.0,,4.0,1.0,33.0,2.0,,2.0,95.0,0.0,12.0,1.0,44.0,4.0,1.0,,1.0,2.0,13.0,4.0,3.0,7.0,8.0,46.0,2.0,1.0,6.0,15.0,14.0,28.0,3.0,1.0,3.0,2.0,59.0,2.0,1.0,,20.0,1.0,0.0,88.0,0.0,3.0,,,,,8.0,,,5.0,2.0,0.0,2.0,0.0,5.0,17.0,47.0,4.0,2.0,18.0,18.0,80.0,7.0,0.0,3.0,1.0,,9.0,0.0,0.0,60.0,200.0,,16.0,1.0,4.0,2.0,0.0,0.0,0.0,,0.0,,0.0,0.0,1.0,3.0,,0.0,0.0
2023-12-29 00:00:00+00:00,193.0,,95.0,6.0,,489.0,,34.0,225.0,5.0,73.0,3.0,28.0,12.0,0.0,19.0,9.0,,,6.0,1.0,3.0,1.0,25.0,2.0,,11.0,,10.0,2.0,0.0,,,42.0,1.0,,31.0,11.0,,39.0,32.0,26.0,,1.0,,11.0,1.0,39.0,2.0,,1.0,76.0,0.0,17.0,0.0,50.0,4.0,2.0,,4.0,1.0,4.0,11.0,6.0,4.0,13.0,38.0,1.0,2.0,5.0,9.0,3.0,51.0,2.0,7.0,5.0,0.0,33.0,4.0,0.0,,19.0,0.0,0.0,61.0,0.0,2.0,,,,,4.0,,,3.0,6.0,2.0,0.0,0.0,4.0,9.0,44.0,7.0,0.0,18.0,21.0,81.0,7.0,7.0,2.0,1.0,,11.0,0.0,0.0,64.0,177.0,,24.0,0.0,4.0,0.0,0.0,0.0,3.0,,0.0,,4.0,5.0,4.0,2.0,,1.0,1.0
2023-12-30 00:00:00+00:00,150.0,,98.0,9.0,,476.0,,20.0,213.0,12.0,97.0,9.0,17.0,11.0,0.0,23.0,5.0,,,1.0,0.0,4.0,4.0,22.0,1.0,,6.0,,42.0,1.0,2.0,,,36.0,4.0,,10.0,13.0,,20.0,59.0,27.0,,2.0,,9.0,0.0,31.0,3.0,,0.0,71.0,0.0,23.0,0.0,59.0,2.0,1.0,,23.0,0.0,2.0,5.0,5.0,3.0,2.0,43.0,1.0,1.0,4.0,8.0,6.0,51.0,3.0,1.0,1.0,0.0,43.0,7.0,0.0,,6.0,0.0,0.0,72.0,0.0,1.0,,,,,1.0,,,3.0,4.0,0.0,3.0,2.0,5.0,15.0,43.0,12.0,11.0,16.0,16.0,87.0,1.0,7.0,1.0,2.0,,13.0,0.0,0.0,47.0,171.0,,22.0,0.0,1.0,0.0,0.0,0.0,0.0,,0.0,,0.0,4.0,2.0,0.0,,1.0,0.0
2023-12-31 00:00:00+00:00,187.0,,89.0,15.0,,427.0,,24.0,144.0,6.0,97.0,0.0,13.0,8.0,0.0,26.0,11.0,,,1.0,0.0,1.0,3.0,10.0,3.0,,6.0,,8.0,1.0,3.0,,,37.0,3.0,,14.0,14.0,,17.0,51.0,35.0,,1.0,,14.0,0.0,21.0,1.0,,16.0,85.0,2.0,16.0,0.0,350.0,5.0,5.0,,5.0,1.0,7.0,3.0,4.0,5.0,3.0,58.0,3.0,3.0,2.0,7.0,12.0,56.0,1.0,0.0,0.0,0.0,35.0,6.0,5.0,,1.0,0.0,0.0,97.0,0.0,6.0,,,,,1.0,,,5.0,2.0,1.0,3.0,0.0,4.0,1.0,43.0,3.0,8.0,18.0,7.0,33.0,5.0,2.0,3.0,0.0,,8.0,0.0,0.0,46.0,166.0,,20.0,0.0,0.0,2.0,0.0,0.0,1.0,,1.0,,0.0,4.0,1.0,3.0,,2.0,0.0
2024-01-01 00:00:00+00:00,110.0,,98.0,17.0,,387.0,,34.0,162.0,9.0,76.0,4.0,22.0,5.0,0.0,35.0,11.0,,,1.0,0.0,3.0,54.0,28.0,0.0,,7.0,,20.0,4.0,3.0,,,27.0,1.0,,10.0,10.0,,28.0,45.0,17.0,,1.0,,6.0,1.0,26.0,0.0,,5.0,104.0,0.0,15.0,0.0,289.0,4.0,2.0,,3.0,1.0,13.0,4.0,10.0,5.0,6.0,22.0,2.0,1.0,3.0,9.0,24.0,31.0,2.0,3.0,1.0,1.0,33.0,3.0,1.0,,9.0,0.0,0.0,73.0,0.0,1.0,,,,,0.0,,,13.0,3.0,0.0,5.0,1.0,10.0,6.0,29.0,2.0,18.0,10.0,22.0,54.0,1.0,4.0,1.0,0.0,,5.0,0.0,0.0,21.0,145.0,,21.0,0.0,6.0,0.0,0.0,0.0,0.0,,0.0,,1.0,2.0,5.0,1.0,,1.0,0.0
2024-01-02 00:00:00+00:00,138.0,,113.0,15.0,,521.0,,41.0,183.0,18.0,140.0,0.0,21.0,10.0,0.0,36.0,12.0,,,5.0,0.0,3.0,13.0,27.0,5.0,,10.0,,20.0,5.0,5.0,,,55.0,17.0,,11.0,14.0,,33.0,40.0,35.0,,1.0,,9.0,0.0,16.0,1.0,,3.0,210.0,0.0,17.0,1.0,112.0,4.0,5.0,,2.0,1.0,4.0,5.0,3.0,12.0,4.0,56.0,1.0,4.0,1.0,19.0,24.0,21.0,4.0,4.0,5.0,0.0,39.0,13.0,0.0,,11.0,0.0,0.0,96.0,0.0,4.0,,,,,2.0,,,3.0,2.0,1.0,2.0,0.0,4.0,11.0,68.0,6.0,5.0,44.0,70.0,69.0,5.0,3.0,1.0,1.0,,5.0,0.0,0.0,42.0,190.0,,37.0,2.0,1.0,4.0,0.0,0.0,0.0,,0.0,,1.0,2.0,2.0,2.0,,8.0,0.0
2024-01-03 00:00:00+00:00,189.0,,114.0,18.0,,496.0,,81.0,176.0,37.0,81.0,0.0,26.0,6.0,0.0,34.0,8.0,,,2.0,0.0,6.0,16.0,30.0,1.0,,6.0,,16.0,1.0,6.0,,,62.0,10.0,,13.0,14.0,,30.0,62.0,29.0,,1.0,,11.0,4.0,42.0,1.0,,2.0,118.0,1.0,16.0,1.0,54.0,6.0,8.0,,0.0,0.0,4.0,4.0,4.0,12.0,2.0,42.0,0.0,21.0,6.0,7.0,16.0,19.0,1.0,2.0,5.0,1.0,41.0,1.0,1.0,,12.0,0.0,0.0,119.0,0.0,4.0,,,,,2.0,,,5.0,3.0,0.0,2.0,2.0,4.0,8.0,59.0,5.0,0.0,19.0,68.0,96.0,4.0,6.0,2.0,1.0,,5.0,0.0,1.0,67.0,233.0,,24.0,0.0,3.0,1.0,0.0,0.0,0.0,,0.0,,2.0,3.0,0.0,2.0,,2.0,0.0
2024-01-04 00:00:00+00:00,198.0,,134.0,19.0,,472.0,,41.0,228.0,38.0,101.0,2.0,35.0,18.0,0.0,22.0,17.0,,,2.0,0.0,10.0,11.0,31.0,2.0,,14.0,,14.0,0.0,5.0,,,106.0,7.0,,31.0,11.0,,26.0,24.0,24.0,,2.0,,7.0,1.0,26.0,2.0,,1.0,157.0,0.0,16.0,4.0,45.0,8.0,0.0,,2.0,1.0,11.0,13.0,9.0,5.0,10.0,35.0,1.0,6.0,7.0,33.0,40.0,33.0,2.0,3.0,2.0,0.0,34.0,3.0,2.0,,9.0,0.0,0.0,83.0,0.0,5.0,,,,,0.0,,,6.0,0.0,1.0,1.0,4.0,3.0,10.0,53.0,1.0,2.0,31.0,9.0,69.0,4.0,1.0,4.0,1.0,,9.0,0.0,0.0,59.0,190.0,,27.0,1.0,0.0,1.0,0.0,0.0,0.0,,0.0,,5.0,0.0,2.0,1.0,,0.0,0.0
2024-01-05 00:00:00+00:00,220.0,,151.0,13.0,,559.0,,36.0,186.0,29.0,54.0,1.0,27.0,9.0,0.0,27.0,7.0,,,6.0,0.0,4.0,10.0,14.0,2.0,,12.0,,8.0,7.0,7.0,,,81.0,5.0,,13.0,12.0,,8.0,45.0,34.0,,2.0,,16.0,0.0,28.0,6.0,,2.0,126.0,0.0,16.0,0.0,68.0,7.0,0.0,,2.0,2.0,2.0,8.0,6.0,6.0,6.0,24.0,1.0,2.0,7.0,13.0,27.0,20.0,1.0,2.0,0.0,0.0,48.0,2.0,0.0,,17.0,0.0,0.0,65.0,0.0,4.0,,,,,3.0,,,3.0,2.0,1.0,1.0,0.0,2.0,9.0,58.0,3.0,2.0,35.0,11.0,81.0,2.0,0.0,2.0,3.0,,11.0,3.0,0.0,87.0,221.0,,14.0,1.0,0.0,0.0,0.0,0.0,0.0,,0.0,,3.0,0.0,6.0,1.0,,4.0,0.0
2024-01-06 00:00:00+00:00,114.0,,63.0,9.0,,508.0,,40.0,183.0,62.0,55.0,0.0,17.0,2.0,0.0,26.0,10.0,,,1.0,0.0,0.0,15.0,9.0,2.0,,7.0,,8.0,3.0,6.0,,,43.0,4.0,,14.0,9.0,,34.0,46.0,16.0,,0.0,,5.0,0.0,24.0,4.0,,0.0,116.0,1.0,15.0,1.0,47.0,2.0,0.0,,1.0,3.0,2.0,24.0,4.0,3.0,6.0,37.0,0.0,0.0,5.0,7.0,19.0,24.0,0.0,1.0,2.0,1.0,28.0,4.0,1.0,,8.0,0.0,0.0,100.0,0.0,4.0,,,,,1.0,,,1.0,2.0,0.0,1.0,1.0,3.0,4.0,45.0,1.0,0.0,22.0,8.0,68.0,6.0,1.0,0.0,0.0,,3.0,1.0,0.0,44.0,162.0,,23.0,1.0,0.0,1.0,0.0,0.0,0.0,,0.0,,1.0,0.0,2.0,0.0,,0.0,0.0
2024-01-07 00:00:00+00:00,110.0,,95.0,6.0,,424.0,,36.0,154.0,40.0,39.0,1.0,19.0,2.0,0.0,28.0,2.0,,,5.0,0.0,2.0,5.0,29.0,2.0,,12.0,,19.0,2.0,5.0,,,47.0,10.0,,10.0,15.0,,13.0,38.0,25.0,,0.0,,2.0,0.0,13.0,2.0,,1.0,63.0,0.0,14.0,1.0,24.0,5.0,0.0,,3.0,3.0,8.0,2.0,6.0,2.0,1.0,26.0,1.0,0.0,8.0,5.0,12.0,25.0,0.0,5.0,2.0,0.0,39.0,5.0,0.0,,18.0,0.0,0.0,88.0,0.0,1.0,,,,,2.0,,,2.0,1.0,1.0,0.0,0.0,8.0,7.0,46.0,7.0,0.0,19.0,13.0,66.0,2.0,2.0,2.0,4.0,,3.0,0.0,0.0,40.0,186.0,,19.0,0.0,2.0,0.0,0.0,3.0,0.0,,0.0,,6.0,0.0,2.0,0.0,,1.0,0.0
2024-01-08 00:00:00+00:00,196.0,,95.0,16.0,,488.0,,71.0,314.0,22.0,49.0,0.0,21.0,2.0,0.0,25.0,18.0,,,6.0,0.0,6.0,8.0,33.0,5.0,,5.0,,10.0,3.0,2.0,,,64.0,15.0,,2.0,19.0,,24.0,45.0,35.0,,4.0,,2.0,0.0,20.0,0.0,,3.0,69.0,0.0,18.0,1.0,35.0,2.0,0.0,,0.0,1.0,2.0,6.0,6.0,4.0,7.0,34.0,1.0,3.0,8.0,15.0,22.0,26.0,0.0,3.0,2.0,1.0,50.0,4.0,1.0,,18.0,0.0,0.0,88.0,0.0,4.0,,,,,0.0,,,2.0,1.0,6.0,2.0,2.0,4.0,7.0,64.0,3.0,4.0,19.0,17.0,61.0,3.0,3.0,2.0,0.0,,6.0,0.0,1.0,45.0,235.0,,37.0,3.0,0.0,0.0,3.0,0.0,0.0,,1.0,,4.0,3.0,0.0,0.0,,0.0,0.0
2024-01-09 00:00:00+00:00,140.0,,76.0,18.0,,491.0,,48.0,233.0,38.0,29.0,0.0,20.0,7.0,0.0,23.0,18.0,,,2.0,1.0,5.0,11.0,20.0,6.0,,8.0,,7.0,3.0,1.0,,,58.0,3.0,,7.0,7.0,,24.0,26.0,15.0,,1.0,,4.0,1.0,28.0,1.0,,1.0,24.0,0.0,15.0,1.0,21.0,23.0,6.0,,0.0,0.0,5.0,11.0,2.0,6.0,8.0,39.0,4.0,2.0,6.0,10.0,24.0,18.0,1.0,2.0,1.0,0.0,41.0,3.0,4.0,,0.0,0.0,0.0,126.0,4.0,4.0,,,,,2.0,,,2.0,2.0,1.0,3.0,1.0,1.0,9.0,56.0,1.0,2.0,20.0,9.0,71.0,8.0,3.0,1.0,2.0,,10.0,0.0,0.0,44.0,212.0,,27.0,1.0,4.0,0.0,2.0,0.0,0.0,,0.0,,16.0,7.0,2.0,0.0,,1.0,0.0
2024-01-10 00:00:00+00:00,154.0,,61.0,17.0,,464.0,,52.0,104.0,95.0,37.0,0.0,20.0,16.0,0.0,11.0,11.0,,,1.0,0.0,0.0,6.0,79.0,3.0,,9.0,,2.0,1.0,2.0,,,57.0,2.0,,8.0,24.0,,28.0,27.0,19.0,,3.0,,23.0,1.0,35.0,2.0,,1.0,3.0,0.0,20.0,2.0,21.0,6.0,1.0,,0.0,2.0,21.0,5.0,4.0,4.0,2.0,32.0,0.0,0.0,7.0,8.0,18.0,24.0,1.0,3.0,2.0,1.0,44.0,7.0,1.0,,0.0,0.0,0.0,96.0,1.0,3.0,,,,,0.0,,,2.0,2.0,3.0,1.0,5.0,8.0,4.0,55.0,1.0,0.0,16.0,17.0,83.0,7.0,9.0,0.0,1.0,,4.0,0.0,0.0,39.0,242.0,,15.0,0.0,0.0,1.0,0.0,1.0,0.0,,0.0,,6.0,1.0,0.0,0.0,,0.0,0.0
2024-01-11 00:00:00+00:00,188.0,,81.0,14.0,,712.0,,45.0,107.0,53.0,21.0,0.0,15.0,23.0,0.0,28.0,8.0,,,2.0,0.0,0.0,8.0,34.0,3.0,,11.0,,6.0,1.0,2.0,,,34.0,3.0,,5.0,12.0,,29.0,20.0,30.0,,5.0,,17.0,1.0,21.0,4.0,,0.0,3.0,0.0,18.0,2.0,14.0,5.0,5.0,,2.0,3.0,2.0,4.0,5.0,1.0,5.0,35.0,3.0,3.0,19.0,13.0,4.0,20.0,1.0,1.0,2.0,0.0,36.0,4.0,6.0,,0.0,0.0,0.0,109.0,0.0,4.0,,,,,0.0,,,6.0,0.0,0.0,0.0,0.0,4.0,6.0,47.0,2.0,0.0,14.0,8.0,50.0,4.0,6.0,1.0,0.0,,3.0,0.0,0.0,43.0,236.0,,27.0,2.0,0.0,0.0,0.0,1.0,0.0,,1.0,,2.0,0.0,2.0,0.0,,6.0,0.0
2024-01-12 00:00:00+00:00,194.0,,77.0,17.0,,647.0,,49.0,92.0,39.0,38.0,3.0,13.0,20.0,0.0,45.0,18.0,,,1.0,0.0,3.0,17.0,18.0,5.0,,16.0,,7.0,1.0,2.0,,,32.0,1.0,,8.0,18.0,,23.0,27.0,30.0,,1.0,,14.0,0.0,14.0,3.0,,1.0,22.0,0.0,17.0,2.0,14.0,4.0,5.0,,1.0,0.0,3.0,3.0,5.0,0.0,6.0,25.0,3.0,1.0,7.0,15.0,9.0,31.0,1.0,8.0,6.0,0.0,60.0,4.0,4.0,,3.0,0.0,0.0,127.0,0.0,4.0,,,,,0.0,,,0.0,4.0,0.0,0.0,0.0,3.0,8.0,57.0,5.0,2.0,45.0,10.0,77.0,5.0,4.0,4.0,0.0,,7.0,0.0,0.0,32.0,229.0,,31.0,0.0,1.0,2.0,1.0,0.0,0.0,,1.0,,19.0,5.0,7.0,0.0,,5.0,0.0
2024-01-13 00:00:00+00:00,91.0,,65.0,11.0,,501.0,,39.0,99.0,36.0,47.0,2.0,23.0,4.0,0.0,30.0,10.0,,,1.0,0.0,1.0,15.0,29.0,2.0,,10.0,,11.0,2.0,0.0,,,29.0,1.0,,10.0,10.0,,14.0,45.0,24.0,,1.0,,5.0,0.0,19.0,2.0,,1.0,55.0,0.0,6.0,0.0,3.0,3.0,0.0,,2.0,1.0,3.0,1.0,7.0,2.0,5.0,37.0,1.0,2.0,8.0,6.0,8.0,19.0,0.0,0.0,5.0,0.0,42.0,4.0,0.0,,2.0,0.0,0.0,122.0,0.0,3.0,,,,,1.0,,,1.0,1.0,0.0,0.0,1.0,3.0,6.0,49.0,5.0,0.0,24.0,19.0,51.0,4.0,3.0,0.0,2.0,,7.0,1.0,0.0,39.0,166.0,,25.0,0.0,0.0,1.0,0.0,0.0,0.0,,0.0,,3.0,7.0,1.0,0.0,,4.0,0.0
2024-01-14 00:00:00+00:00,103.0,,58.0,12.0,,478.0,,24.0,71.0,14.0,46.0,0.0,12.0,11.0,1.0,18.0,4.0,,,1.0,0.0,0.0,4.0,17.0,0.0,,9.0,,4.0,1.0,1.0,,,30.0,7.0,,4.0,14.0,,21.0,43.0,27.0,,0.0,,5.0,0.0,21.0,2.0,,0.0,44.0,0.0,18.0,0.0,3.0,0.0,1.0,,0.0,0.0,2.0,0.0,19.0,0.0,1.0,16.0,2.0,2.0,2.0,6.0,9.0,27.0,0.0,0.0,3.0,0.0,47.0,0.0,0.0,,2.0,0.0,0.0,77.0,0.0,4.0,,,,,2.0,,,1.0,0.0,0.0,2.0,1.0,1.0,0.0,35.0,0.0,0.0,12.0,22.0,52.0,3.0,0.0,1.0,4.0,,3.0,0.0,0.0,42.0,174.0,,21.0,2.0,0.0,0.0,0.0,0.0,0.0,,0.0,,1.0,4.0,2.0,0.0,,3.0,0.0
2024-01-15 00:00:00+00:00,154.0,,77.0,25.0,,487.0,,48.0,111.0,43.0,43.0,1.0,21.0,16.0,0.0,17.0,11.0,,,3.0,0.0,3.0,6.0,13.0,1.0,,7.0,,4.0,5.0,2.0,,,33.0,5.0,,9.0,13.0,,19.0,20.0,29.0,,0.0,,2.0,2.0,18.0,1.0,,0.0,134.0,0.0,18.0,2.0,21.0,3.0,1.0,,0.0,0.0,4.0,2.0,4.0,4.0,6.0,29.0,3.0,2.0,4.0,7.0,13.0,26.0,1.0,0.0,3.0,10.0,38.0,7.0,1.0,,2.0,0.0,0.0,87.0,0.0,2.0,,,,,1.0,,,3.0,1.0,2.0,0.0,2.0,6.0,6.0,78.0,0.0,0.0,19.0,11.0,94.0,3.0,1.0,2.0,3.0,,6.0,0.0,0.0,51.0,191.0,,30.0,0.0,1.0,1.0,2.0,0.0,0.0,,0.0,,1.0,12.0,2.0,0.0,,6.0,0.0
2024-01-16 00:00:00+00:00,240.0,,88.0,37.0,,494.0,,39.0,153.0,52.0,68.0,2.0,11.0,16.0,0.0,43.0,14.0,,,3.0,0.0,5.0,9.0,26.0,1.0,,6.0,,12.0,2.0,4.0,,,31.0,14.0,,10.0,7.0,,12.0,32.0,46.0,,1.0,,8.0,4.0,24.0,4.0,,0.0,94.0,0.0,8.0,1.0,9.0,4.0,1.0,,2.0,0.0,1.0,3.0,6.0,3.0,4.0,32.0,3.0,4.0,4.0,12.0,27.0,55.0,3.0,1.0,3.0,4.0,35.0,0.0,0.0,,1.0,0.0,0.0,101.0,0.0,3.0,,,,,1.0,,,2.0,1.0,1.0,1.0,1.0,7.0,22.0,57.0,1.0,2.0,24.0,8.0,79.0,7.0,0.0,3.0,2.0,,2.0,0.0,1.0,94.0,160.0,,26.0,3.0,2.0,2.0,4.0,0.0,0.0,,0.0,,8.0,7.0,5.0,2.0,,4.0,0.0
2024-01-17 00:00:00+00:00,323.0,,91.0,20.0,,431.0,,37.0,98.0,35.0,52.0,0.0,26.0,14.0,0.0,47.0,12.0,,,6.0,0.0,4.0,10.0,33.0,5.0,,7.0,,9.0,8.0,1.0,,,44.0,8.0,,8.0,13.0,,13.0,35.0,41.0,,6.0,,22.0,2.0,26.0,5.0,,3.0,104.0,0.0,21.0,1.0,56.0,2.0,1.0,,2.0,0.0,2.0,4.0,12.0,8.0,10.0,24.0,1.0,2.0,3.0,19.0,11.0,50.0,2.0,1.0,3.0,1.0,43.0,2.0,2.0,,0.0,0.0,0.0,70.0,0.0,3.0,,,,,4.0,,,1.0,0.0,4.0,1.0,2.0,3.0,42.0,62.0,2.0,1.0,25.0,3.0,89.0,4.0,2.0,3.0,1.0,,6.0,0.0,1.0,65.0,198.0,,31.0,2.0,0.0,0.0,1.0,0.0,0.0,,0.0,,11.0,1.0,5.0,0.0,,3.0,0.0
2024-01-18 00:00:00+00:00,137.0,,100.0,13.0,,469.0,,41.0,88.0,48.0,42.0,0.0,22.0,14.0,0.0,93.0,11.0,,,3.0,0.0,6.0,5.0,35.0,5.0,,21.0,,12.0,9.0,2.0,,,36.0,6.0,,6.0,12.0,,12.0,19.0,33.0,,1.0,,15.0,2.0,44.0,1.0,,3.0,74.0,0.0,19.0,3.0,40.0,5.0,2.0,,0.0,1.0,2.0,2.0,6.0,2.0,11.0,33.0,2.0,2.0,7.0,59.0,6.0,23.0,2.0,2.0,3.0,0.0,52.0,2.0,1.0,,0.0,0.0,1.0,138.0,1.0,10.0,,,,,1.0,,,7.0,4.0,3.0,3.0,1.0,3.0,25.0,82.0,0.0,1.0,28.0,13.0,84.0,1.0,2.0,2.0,2.0,,4.0,0.0,0.0,53.0,183.0,,25.0,0.0,0.0,2.0,2.0,0.0,1.0,,1.0,,5.0,0.0,2.0,0.0,,4.0,0.0
2024-01-19 00:00:00+00:00,152.0,,89.0,10.0,,457.0,,44.0,68.0,41.0,54.0,0.0,32.0,13.0,0.0,31.0,6.0,,,2.0,0.0,2.0,6.0,43.0,3.0,,10.0,,13.0,1.0,1.0,,,25.0,7.0,,5.0,12.0,,16.0,34.0,21.0,,1.0,,11.0,0.0,97.0,1.0,,5.0,76.0,0.0,8.0,1.0,23.0,4.0,2.0,,2.0,0.0,1.0,3.0,6.0,6.0,12.0,26.0,2.0,1.0,6.0,25.0,8.0,26.0,1.0,1.0,4.0,2.0,26.0,2.0,0.0,,0.0,0.0,0.0,139.0,0.0,4.0,,,,,0.0,,,2.0,2.0,0.0,1.0,1.0,3.0,85.0,43.0,4.0,1.0,28.0,3.0,61.0,4.0,1.0,3.0,2.0,,6.0,0.0,0.0,54.0,191.0,,18.0,2.0,1.0,4.0,2.0,2.0,0.0,,0.0,,10.0,5.0,2.0,1.0,,6.0,0.0
2024-01-20 00:00:00+00:00,155.0,,70.0,6.0,,408.0,,26.0,59.0,31.0,49.0,0.0,60.0,7.0,0.0,26.0,5.0,,,0.0,0.0,4.0,3.0,18.0,5.0,,10.0,,11.0,0.0,0.0,,,30.0,2.0,,8.0,9.0,,5.0,18.0,42.0,,2.0,,11.0,0.0,90.0,1.0,,76.0,80.0,0.0,11.0,0.0,12.0,8.0,0.0,,13.0,1.0,1.0,1.0,4.0,4.0,1.0,62.0,4.0,0.0,4.0,13.0,6.0,28.0,1.0,1.0,12.0,1.0,44.0,0.0,0.0,,0.0,0.0,0.0,94.0,0.0,2.0,,,,,5.0,,,1.0,2.0,2.0,3.0,0.0,3.0,180.0,45.0,1.0,0.0,24.0,6.0,63.0,4.0,2.0,1.0,2.0,,3.0,0.0,0.0,63.0,147.0,,13.0,1.0,0.0,0.0,2.0,0.0,0.0,,0.0,,2.0,0.0,3.0,1.0,,2.0,0.0
2024-01-21 00:00:00+00:00,166.0,,75.0,15.0,66.0,462.0,0.0,50.0,59.0,38.0,38.0,0.0,92.0,16.0,0.0,15.0,9.0,9.0,,0.0,0.0,1.0,1.0,17.0,5.0,2.0,10.0,,15.0,2.0,3.0,,,39.0,9.0,5.0,10.0,12.0,1.0,37.0,41.0,44.0,0.0,0.0,,3.0,0.0,65.0,4.0,,23.0,32.0,1.0,10.0,1.0,6.0,4.0,0.0,,3.0,0.0,3.0,2.0,3.0,5.0,1.0,31.0,5.0,0.0,6.0,9.0,13.0,17.0,1.0,0.0,6.0,1.0,39.0,3.0,1.0,0.0,0.0,0.0,0.0,121.0,0.0,5.0,,,21.0,,1.0,,,0.0,0.0,3.0,1.0,12.0,1.0,9.0,43.0,1.0,0.0,14.0,4.0,61.0,1.0,0.0,1.0,1.0,,6.0,0.0,1.0,59.0,202.0,,120.0,1.0,0.0,1.0,2.0,0.0,0.0,,0.0,1.0,3.0,2.0,2.0,0.0,,7.0,0.0
2024-01-22 00:00:00+00:00,168.0,,70.0,12.0,84.0,457.0,1.0,26.0,92.0,45.0,46.0,1.0,34.0,15.0,0.0,19.0,6.0,21.0,,2.0,0.0,4.0,8.0,16.0,1.0,4.0,14.0,,16.0,0.0,2.0,,,22.0,1.0,7.0,24.0,10.0,0.0,30.0,28.0,29.0,0.0,0.0,,9.0,1.0,61.0,2.0,,15.0,63.0,1.0,8.0,5.0,11.0,4.0,0.0,,1.0,1.0,5.0,3.0,5.0,4.0,6.0,29.0,2.0,0.0,8.0,21.0,6.0,20.0,1.0,0.0,5.0,4.0,37.0,7.0,7.0,1.0,0.0,0.0,0.0,125.0,0.0,2.0,,,19.0,,2.0,,,1.0,3.0,1.0,1.0,12.0,2.0,20.0,67.0,1.0,2.0,20.0,7.0,57.0,2.0,1.0,9.0,1.0,,6.0,0.0,1.0,60.0,172.0,,122.0,0.0,0.0,4.0,2.0,0.0,0.0,,0.0,7.0,3.0,10.0,1.0,2.0,,3.0,0.0
2024-01-23 00:00:00+00:00,123.0,,70.0,17.0,56.0,464.0,1.0,31.0,87.0,24.0,44.0,1.0,28.0,15.0,0.0,34.0,12.0,16.0,,2.0,0.0,3.0,7.0,13.0,5.0,1.0,11.0,,20.0,5.0,1.0,,,25.0,6.0,8.0,5.0,11.0,1.0,24.0,37.0,39.0,0.0,3.0,,5.0,0.0,86.0,3.0,,14.0,83.0,0.0,7.0,1.0,21.0,4.0,1.0,,1.0,2.0,0.0,4.0,3.0,2.0,1.0,19.0,2.0,5.0,6.0,16.0,7.0,16.0,0.0,0.0,4.0,4.0,52.0,6.0,0.0,0.0,0.0,0.0,0.0,112.0,2.0,3.0,,,21.0,,1.0,,,0.0,4.0,3.0,0.0,1.0,5.0,13.0,63.0,0.0,2.0,17.0,6.0,62.0,5.0,1.0,3.0,3.0,,11.0,0.0,3.0,42.0,176.0,,126.0,1.0,0.0,0.0,1.0,1.0,0.0,,0.0,11.0,21.0,0.0,6.0,1.0,,12.0,0.0
2024-01-24 00:00:00+00:00,134.0,,78.0,12.0,56.0,499.0,0.0,41.0,76.0,46.0,47.0,0.0,25.0,15.0,0.0,19.0,13.0,11.0,,4.0,0.0,1.0,4.0,24.0,13.0,7.0,15.0,,16.0,4.0,2.0,,,22.0,9.0,5.0,8.0,14.0,0.0,23.0,29.0,20.0,0.0,4.0,,3.0,1.0,67.0,0.0,,6.0,63.0,0.0,10.0,1.0,14.0,4.0,0.0,,3.0,1.0,2.0,5.0,3.0,3.0,6.0,35.0,1.0,1.0,8.0,11.0,6.0,23.0,2.0,1.0,3.0,4.0,47.0,6.0,4.0,0.0,0.0,0.0,0.0,112.0,0.0,4.0,,,34.0,,0.0,,,2.0,1.0,5.0,1.0,3.0,4.0,9.0,53.0,0.0,0.0,33.0,8.0,56.0,3.0,6.0,6.0,2.0,,17.0,0.0,0.0,40.0,184.0,,123.0,0.0,0.0,4.0,3.0,0.0,0.0,,0.0,4.0,19.0,1.0,3.0,0.0,,9.0,0.0
2024-01-25 00:00:00+00:00,130.0,,104.0,14.0,59.0,453.0,1.0,29.0,41.0,42.0,39.0,4.0,28.0,26.0,4.0,16.0,9.0,11.0,,1.0,0.0,1.0,7.0,23.0,6.0,4.0,9.0,,17.0,4.0,1.0,,,26.0,16.0,1.0,23.0,8.0,0.0,15.0,57.0,26.0,0.0,2.0,,4.0,3.0,44.0,1.0,,4.0,79.0,0.0,13.0,9.0,15.0,11.0,1.0,,15.0,2.0,1.0,1.0,6.0,3.0,3.0,22.0,3.0,2.0,9.0,11.0,9.0,21.0,1.0,0.0,4.0,1.0,28.0,4.0,2.0,0.0,6.0,0.0,0.0,101.0,0.0,4.0,,,23.0,,1.0,,,1.0,0.0,2.0,1.0,0.0,5.0,4.0,47.0,1.0,2.0,24.0,10.0,63.0,3.0,0.0,2.0,1.0,,5.0,0.0,0.0,55.0,184.0,,110.0,1.0,1.0,2.0,3.0,0.0,0.0,,0.0,5.0,32.0,0.0,6.0,0.0,,8.0,0.0
2024-01-26 00:00:00+00:00,182.0,,99.0,12.0,23.0,425.0,0.0,43.0,77.0,35.0,40.0,0.0,16.0,22.0,1.0,20.0,10.0,14.0,,1.0,0.0,7.0,8.0,14.0,4.0,4.0,17.0,,4.0,3.0,0.0,,,14.0,2.0,4.0,46.0,16.0,1.0,12.0,38.0,20.0,0.0,1.0,,13.0,0.0,72.0,6.0,,3.0,67.0,0.0,11.0,2.0,8.0,6.0,1.0,,3.0,1.0,5.0,0.0,1.0,4.0,7.0,23.0,5.0,0.0,10.0,14.0,19.0,16.0,0.0,2.0,1.0,1.0,38.0,5.0,1.0,1.0,0.0,0.0,0.0,118.0,0.0,3.0,,,48.0,,1.0,,,2.0,6.0,2.0,2.0,1.0,1.0,0.0,44.0,0.0,1.0,25.0,7.0,75.0,2.0,3.0,1.0,4.0,,10.0,1.0,0.0,62.0,174.0,,106.0,0.0,0.0,2.0,3.0,0.0,0.0,,1.0,9.0,13.0,2.0,5.0,0.0,,1.0,0.0
2024-01-27 00:00:00+00:00,121.0,,98.0,46.0,36.0,376.0,0.0,34.0,54.0,31.0,41.0,0.0,56.0,13.0,0.0,11.0,10.0,7.0,,1.0,0.0,5.0,4.0,9.0,2.0,1.0,23.0,,24.0,7.0,10.0,,,20.0,2.0,2.0,22.0,6.0,0.0,6.0,42.0,32.0,0.0,1.0,,10.0,1.0,35.0,5.0,,46.0,65.0,0.0,13.0,1.0,2.0,12.0,0.0,,0.0,0.0,0.0,1.0,1.0,6.0,5.0,26.0,2.0,1.0,2.0,7.0,2.0,13.0,0.0,1.0,2.0,2.0,28.0,2.0,0.0,2.0,0.0,0.0,0.0,123.0,0.0,5.0,,,22.0,,0.0,,,0.0,0.0,0.0,1.0,1.0,2.0,9.0,39.0,0.0,3.0,24.0,8.0,101.0,2.0,0.0,0.0,5.0,,6.0,0.0,0.0,62.0,168.0,,110.0,0.0,0.0,0.0,0.0,0.0,1.0,,0.0,3.0,1.0,0.0,4.0,1.0,,8.0,0.0
2024-01-28 00:00:00+00:00,103.0,,105.0,8.0,25.0,365.0,1.0,32.0,84.0,46.0,38.0,1.0,57.0,11.0,0.0,19.0,7.0,17.0,,0.0,0.0,5.0,7.0,23.0,12.0,2.0,18.0,,17.0,4.0,3.0,,,17.0,5.0,5.0,28.0,8.0,0.0,5.0,50.0,32.0,0.0,0.0,,7.0,0.0,30.0,7.0,,46.0,53.0,0.0,12.0,6.0,5.0,19.0,1.0,,2.0,1.0,2.0,0.0,0.0,4.0,1.0,32.0,3.0,0.0,6.0,17.0,7.0,23.0,0.0,0.0,2.0,7.0,30.0,1.0,0.0,7.0,2.0,0.0,0.0,93.0,0.0,2.0,,,13.0,,1.0,,,3.0,4.0,1.0,0.0,0.0,2.0,2.0,59.0,1.0,0.0,22.0,4.0,99.0,3.0,1.0,0.0,2.0,,5.0,0.0,1.0,90.0,160.0,,126.0,4.0,0.0,1.0,1.0,0.0,0.0,,0.0,1.0,2.0,0.0,2.0,0.0,,2.0,0.0
2024-01-29 00:00:00+00:00,161.0,,84.0,2.0,32.0,503.0,1.0,37.0,85.0,27.0,64.0,2.0,46.0,30.0,0.0,18.0,7.0,38.0,,1.0,0.0,2.0,12.0,16.0,6.0,5.0,23.0,,18.0,4.0,1.0,,,29.0,16.0,12.0,22.0,14.0,2.0,5.0,61.0,24.0,0.0,2.0,,9.0,1.0,40.0,7.0,,24.0,79.0,0.0,23.0,3.0,13.0,6.0,1.0,,4.0,1.0,1.0,9.0,2.0,7.0,3.0,35.0,5.0,0.0,14.0,38.0,6.0,25.0,1.0,1.0,1.0,3.0,30.0,4.0,0.0,7.0,0.0,0.0,0.0,122.0,0.0,1.0,,,24.0,,0.0,,,3.0,2.0,3.0,2.0,0.0,10.0,7.0,50.0,0.0,1.0,27.0,8.0,67.0,2.0,2.0,1.0,1.0,,9.0,0.0,1.0,109.0,185.0,,114.0,2.0,1.0,1.0,0.0,0.0,0.0,,1.0,8.0,12.0,2.0,4.0,0.0,,4.0,0.0
2024-01-30 00:00:00+00:00,140.0,,94.0,8.0,21.0,505.0,2.0,52.0,91.0,29.0,49.0,0.0,69.0,40.0,0.0,28.0,13.0,45.0,,1.0,0.0,2.0,8.0,15.0,7.0,3.0,21.0,,11.0,1.0,5.0,,,36.0,11.0,8.0,11.0,17.0,1.0,8.0,83.0,22.0,0.0,1.0,,17.0,1.0,36.0,3.0,,31.0,69.0,0.0,16.0,5.0,10.0,3.0,1.0,,4.0,0.0,0.0,1.0,1.0,6.0,5.0,21.0,3.0,2.0,44.0,45.0,8.0,35.0,1.0,1.0,4.0,1.0,32.0,3.0,0.0,2.0,0.0,0.0,0.0,132.0,0.0,2.0,,,21.0,,1.0,,,2.0,2.0,0.0,1.0,1.0,4.0,7.0,38.0,0.0,2.0,27.0,7.0,66.0,4.0,1.0,1.0,4.0,,7.0,0.0,0.0,82.0,199.0,,135.0,0.0,0.0,1.0,3.0,0.0,0.0,,0.0,6.0,27.0,0.0,2.0,1.0,,10.0,0.0
2024-01-31 00:00:00+00:00,160.0,,123.0,5.0,15.0,476.0,0.0,44.0,67.0,38.0,66.0,0.0,45.0,28.0,0.0,22.0,8.0,23.0,,3.0,0.0,4.0,17.0,21.0,6.0,6.0,11.0,,25.0,6.0,3.0,,,24.0,1.0,8.0,18.0,12.0,1.0,13.0,83.0,32.0,0.0,0.0,,5.0,1.0,44.0,1.0,,36.0,115.0,0.0,13.0,1.0,10.0,16.0,2.0,,5.0,0.0,0.0,3.0,5.0,1.0,6.0,29.0,1.0,3.0,29.0,23.0,7.0,28.0,2.0,0.0,5.0,1.0,49.0,4.0,1.0,1.0,1.0,0.0,0.0,100.0,0.0,2.0,,,19.0,,0.0,,,3.0,1.0,3.0,0.0,1.0,2.0,9.0,49.0,2.0,2.0,19.0,11.0,51.0,1.0,3.0,0.0,0.0,,3.0,1.0,1.0,93.0,187.0,,149.0,1.0,0.0,2.0,0.0,0.0,0.0,,0.0,10.0,13.0,1.0,3.0,0.0,,11.0,3.0
2024-02-01 00:00:00+00:00,196.0,,80.0,19.0,19.0,459.0,0.0,44.0,83.0,16.0,41.0,1.0,39.0,17.0,0.0,23.0,9.0,13.0,,1.0,0.0,2.0,13.0,13.0,9.0,2.0,23.0,,21.0,1.0,2.0,,,15.0,6.0,9.0,17.0,6.0,1.0,2.0,59.0,31.0,0.0,0.0,,7.0,1.0,52.0,0.0,,23.0,70.0,1.0,11.0,3.0,19.0,38.0,0.0,,1.0,0.0,1.0,7.0,5.0,7.0,11.0,30.0,1.0,2.0,15.0,13.0,10.0,25.0,1.0,1.0,4.0,2.0,42.0,3.0,1.0,0.0,0.0,0.0,0.0,113.0,0.0,2.0,,,17.0,,2.0,,,2.0,3.0,1.0,1.0,0.0,3.0,7.0,61.0,0.0,0.0,25.0,6.0,76.0,4.0,3.0,4.0,0.0,,6.0,1.0,1.0,89.0,155.0,,126.0,0.0,0.0,0.0,2.0,3.0,0.0,,2.0,5.0,15.0,1.0,2.0,1.0,,5.0,1.0
2024-02-02 00:00:00+00:00,270.0,,75.0,15.0,19.0,416.0,3.0,33.0,76.0,4.0,58.0,1.0,125.0,31.0,0.0,22.0,7.0,14.0,,2.0,0.0,2.0,5.0,21.0,9.0,12.0,14.0,,19.0,2.0,4.0,,,32.0,8.0,3.0,10.0,13.0,0.0,8.0,36.0,37.0,0.0,2.0,,16.0,0.0,38.0,3.0,,46.0,78.0,0.0,8.0,1.0,13.0,9.0,2.0,,13.0,3.0,1.0,6.0,4.0,4.0,5.0,49.0,4.0,0.0,5.0,14.0,5.0,19.0,0.0,1.0,4.0,6.0,49.0,7.0,2.0,1.0,0.0,0.0,0.0,109.0,1.0,1.0,,,27.0,,0.0,,,1.0,3.0,5.0,1.0,4.0,2.0,9.0,60.0,1.0,3.0,21.0,5.0,89.0,4.0,4.0,2.0,1.0,,4.0,0.0,2.0,84.0,160.0,,153.0,1.0,0.0,0.0,0.0,0.0,0.0,,0.0,6.0,9.0,2.0,2.0,0.0,,1.0,1.0
2024-02-03 00:00:00+00:00,151.0,,108.0,18.0,6.0,367.0,0.0,51.0,44.0,8.0,55.0,0.0,93.0,25.0,0.0,23.0,16.0,19.0,,0.0,0.0,1.0,9.0,7.0,4.0,14.0,18.0,,5.0,0.0,0.0,,,38.0,10.0,12.0,8.0,9.0,1.0,5.0,68.0,17.0,0.0,5.0,,11.0,1.0,33.0,1.0,,30.0,53.0,2.0,9.0,1.0,19.0,11.0,4.0,,11.0,0.0,0.0,3.0,1.0,2.0,3.0,27.0,1.0,1.0,6.0,19.0,4.0,23.0,1.0,0.0,2.0,5.0,33.0,3.0,0.0,3.0,1.0,0.0,0.0,106.0,0.0,3.0,,,19.0,,0.0,,,2.0,1.0,0.0,2.0,0.0,0.0,7.0,41.0,3.0,0.0,16.0,13.0,103.0,1.0,0.0,5.0,0.0,,5.0,0.0,3.0,88.0,153.0,,119.0,2.0,1.0,2.0,0.0,0.0,2.0,,0.0,3.0,4.0,1.0,1.0,0.0,,6.0,0.0
2024-02-04 00:00:00+00:00,168.0,,80.0,8.0,18.0,375.0,2.0,25.0,47.0,6.0,36.0,0.0,56.0,22.0,0.0,19.0,5.0,4.0,,0.0,0.0,0.0,5.0,17.0,5.0,8.0,12.0,,13.0,5.0,0.0,,,28.0,9.0,9.0,5.0,19.0,2.0,5.0,60.0,24.0,0.0,1.0,,4.0,0.0,34.0,0.0,,5.0,36.0,0.0,11.0,1.0,3.0,8.0,1.0,,22.0,0.0,0.0,1.0,2.0,2.0,1.0,37.0,0.0,0.0,3.0,4.0,2.0,19.0,0.0,2.0,1.0,2.0,28.0,0.0,0.0,2.0,0.0,0.0,0.0,84.0,0.0,0.0,,,19.0,,2.0,,,3.0,7.0,1.0,2.0,4.0,1.0,1.0,27.0,3.0,4.0,16.0,3.0,105.0,4.0,5.0,2.0,3.0,,1.0,0.0,0.0,67.0,183.0,,110.0,1.0,1.0,0.0,1.0,0.0,2.0,,0.0,1.0,4.0,0.0,1.0,1.0,,5.0,0.0
2024-02-05 00:00:00+00:00,231.0,,86.0,15.0,21.0,403.0,0.0,31.0,53.0,8.0,34.0,0.0,46.0,27.0,2.0,10.0,14.0,17.0,,1.0,0.0,2.0,5.0,34.0,3.0,7.0,16.0,,17.0,2.0,1.0,,,32.0,12.0,8.0,16.0,9.0,1.0,10.0,47.0,25.0,0.0,1.0,,17.0,0.0,18.0,1.0,,10.0,55.0,0.0,14.0,5.0,27.0,19.0,1.0,,16.0,2.0,0.0,1.0,4.0,2.0,15.0,30.0,11.0,2.0,8.0,17.0,10.0,26.0,1.0,1.0,6.0,3.0,36.0,3.0,1.0,3.0,0.0,0.0,0.0,86.0,0.0,3.0,,,18.0,,2.0,,,0.0,1.0,2.0,0.0,5.0,2.0,3.0,49.0,1.0,1.0,19.0,6.0,96.0,2.0,2.0,1.0,4.0,,5.0,0.0,2.0,54.0,174.0,,129.0,2.0,1.0,1.0,0.0,0.0,0.0,,1.0,5.0,17.0,3.0,0.0,2.0,,9.0,0.0
2024-02-06 00:00:00+00:00,170.0,,72.0,7.0,6.0,423.0,1.0,40.0,44.0,4.0,55.0,1.0,57.0,29.0,0.0,13.0,8.0,11.0,,3.0,0.0,2.0,7.0,14.0,1.0,5.0,25.0,,49.0,6.0,0.0,,,80.0,4.0,4.0,13.0,6.0,2.0,4.0,44.0,20.0,0.0,4.0,,22.0,1.0,27.0,2.0,,8.0,137.0,0.0,19.0,1.0,11.0,8.0,0.0,,7.0,1.0,2.0,3.0,7.0,2.0,4.0,24.0,3.0,0.0,5.0,11.0,10.0,29.0,3.0,1.0,3.0,4.0,47.0,4.0,2.0,4.0,0.0,0.0,0.0,131.0,0.0,4.0,,,22.0,,1.0,,,0.0,3.0,3.0,3.0,1.0,1.0,6.0,68.0,2.0,0.0,20.0,9.0,69.0,2.0,4.0,2.0,1.0,,2.0,1.0,2.0,53.0,183.0,,119.0,0.0,0.0,5.0,1.0,4.0,0.0,,2.0,8.0,12.0,2.0,9.0,0.0,,5.0,0.0
2024-02-07 00:00:00+00:00,189.0,,98.0,20.0,12.0,466.0,0.0,35.0,54.0,12.0,38.0,1.0,68.0,12.0,0.0,26.0,6.0,15.0,,1.0,0.0,3.0,4.0,46.0,4.0,7.0,23.0,,38.0,5.0,3.0,,,113.0,12.0,6.0,21.0,7.0,0.0,5.0,35.0,21.0,0.0,1.0,,18.0,2.0,36.0,3.0,,14.0,71.0,0.0,10.0,4.0,9.0,5.0,4.0,,4.0,1.0,8.0,1.0,0.0,3.0,5.0,29.0,4.0,5.0,6.0,15.0,17.0,27.0,3.0,1.0,3.0,2.0,53.0,4.0,6.0,0.0,0.0,0.0,0.0,111.0,0.0,1.0,,,10.0,,1.0,,,0.0,3.0,2.0,1.0,0.0,1.0,6.0,57.0,0.0,7.0,18.0,7.0,71.0,4.0,0.0,2.0,1.0,,7.0,0.0,1.0,50.0,165.0,,158.0,1.0,1.0,0.0,1.0,0.0,0.0,,1.0,5.0,21.0,2.0,3.0,0.0,,8.0,0.0
2024-02-08 00:00:00+00:00,186.0,,106.0,13.0,20.0,491.0,1.0,43.0,54.0,5.0,45.0,0.0,73.0,30.0,0.0,24.0,11.0,7.0,,3.0,0.0,4.0,8.0,77.0,2.0,24.0,19.0,,63.0,5.0,3.0,,,67.0,2.0,1.0,13.0,9.0,3.0,9.0,22.0,22.0,0.0,3.0,,13.0,1.0,24.0,1.0,,3.0,47.0,0.0,12.0,1.0,1.0,5.0,0.0,,3.0,0.0,6.0,2.0,4.0,2.0,8.0,24.0,2.0,1.0,5.0,7.0,10.0,24.0,1.0,2.0,3.0,4.0,58.0,12.0,3.0,1.0,0.0,0.0,0.0,123.0,0.0,1.0,,,25.0,,0.0,,,0.0,2.0,0.0,0.0,3.0,9.0,8.0,48.0,3.0,1.0,21.0,8.0,108.0,2.0,0.0,2.0,1.0,,3.0,1.0,0.0,64.0,203.0,,156.0,3.0,0.0,1.0,1.0,0.0,0.0,,2.0,14.0,13.0,2.0,4.0,0.0,,27.0,0.0
2024-02-09 00:00:00+00:00,111.0,,124.0,14.0,30.0,459.0,1.0,33.0,98.0,4.0,38.0,0.0,43.0,15.0,0.0,53.0,11.0,27.0,,2.0,0.0,5.0,7.0,50.0,3.0,15.0,14.0,,87.0,3.0,6.0,,,48.0,6.0,8.0,20.0,6.0,0.0,11.0,9.0,27.0,0.0,0.0,,2.0,0.0,37.0,2.0,,4.0,76.0,0.0,18.0,4.0,10.0,3.0,0.0,,2.0,2.0,6.0,1.0,1.0,2.0,5.0,32.0,1.0,1.0,9.0,27.0,12.0,31.0,1.0,1.0,4.0,0.0,47.0,3.0,0.0,4.0,2.0,0.0,0.0,106.0,0.0,7.0,,,15.0,,3.0,,,1.0,0.0,2.0,2.0,0.0,4.0,7.0,47.0,2.0,5.0,25.0,10.0,77.0,5.0,3.0,4.0,0.0,,8.0,0.0,1.0,51.0,203.0,,124.0,1.0,0.0,0.0,1.0,0.0,0.0,,1.0,6.0,7.0,3.0,3.0,0.0,,15.0,0.0
2024-02-10 00:00:00+00:00,75.0,,74.0,5.0,24.0,393.0,0.0,28.0,81.0,7.0,34.0,0.0,51.0,15.0,0.0,31.0,14.0,21.0,,0.0,0.0,5.0,6.0,24.0,5.0,13.0,14.0,,35.0,3.0,2.0,,,32.0,3.0,5.0,10.0,14.0,2.0,4.0,13.0,17.0,0.0,2.0,,8.0,0.0,22.0,1.0,,1.0,67.0,0.0,19.0,0.0,4.0,6.0,2.0,,4.0,0.0,5.0,0.0,1.0,1.0,2.0,37.0,0.0,0.0,10.0,21.0,7.0,16.0,0.0,2.0,3.0,0.0,40.0,1.0,0.0,3.0,0.0,0.0,0.0,86.0,0.0,3.0,,,19.0,,4.0,,,0.0,1.0,1.0,1.0,1.0,2.0,5.0,40.0,0.0,0.0,16.0,11.0,82.0,1.0,1.0,2.0,0.0,,2.0,1.0,1.0,46.0,149.0,,102.0,0.0,0.0,2.0,0.0,0.0,0.0,,0.0,2.0,4.0,0.0,3.0,1.0,,4.0,0.0
2024-02-11 00:00:00+00:00,166.0,,61.0,14.0,25.0,395.0,0.0,31.0,106.0,7.0,39.0,0.0,28.0,14.0,0.0,23.0,15.0,17.0,,1.0,0.0,6.0,7.0,14.0,1.0,16.0,13.0,,22.0,1.0,1.0,,,36.0,9.0,2.0,8.0,11.0,0.0,7.0,9.0,17.0,0.0,3.0,,9.0,1.0,15.0,3.0,,3.0,84.0,0.0,16.0,1.0,1.0,3.0,3.0,,1.0,1.0,1.0,3.0,1.0,3.0,5.0,41.0,1.0,1.0,1.0,17.0,12.0,15.0,0.0,0.0,3.0,2.0,43.0,14.0,0.0,2.0,1.0,0.0,0.0,80.0,0.0,0.0,,,34.0,,1.0,,,3.0,2.0,0.0,2.0,2.0,1.0,7.0,63.0,0.0,0.0,24.0,7.0,65.0,1.0,15.0,2.0,5.0,,3.0,1.0,0.0,104.0,169.0,,111.0,0.0,1.0,2.0,1.0,0.0,0.0,,0.0,1.0,1.0,1.0,4.0,1.0,,24.0,0.0
2024-02-12 00:00:00+00:00,158.0,,92.0,14.0,8.0,418.0,1.0,29.0,55.0,4.0,62.0,0.0,25.0,10.0,0.0,24.0,15.0,13.0,,2.0,0.0,6.0,6.0,15.0,7.0,4.0,11.0,,12.0,1.0,0.0,,,46.0,5.0,2.0,8.0,9.0,1.0,15.0,10.0,32.0,0.0,0.0,,15.0,0.0,26.0,2.0,,34.0,70.0,0.0,15.0,7.0,8.0,6.0,0.0,,6.0,1.0,3.0,2.0,3.0,3.0,9.0,29.0,0.0,0.0,5.0,13.0,11.0,19.0,1.0,0.0,6.0,0.0,40.0,4.0,1.0,1.0,1.0,0.0,0.0,112.0,0.0,3.0,,,22.0,,5.0,,,0.0,0.0,1.0,0.0,2.0,2.0,3.0,58.0,3.0,0.0,13.0,6.0,83.0,0.0,30.0,2.0,2.0,,2.0,1.0,0.0,108.0,209.0,,143.0,1.0,1.0,0.0,0.0,0.0,0.0,,0.0,7.0,7.0,0.0,4.0,2.0,,0.0,0.0
2024-02-13 00:00:00+00:00,118.0,,67.0,18.0,11.0,442.0,1.0,30.0,71.0,4.0,57.0,0.0,44.0,16.0,0.0,28.0,4.0,22.0,,6.0,0.0,3.0,4.0,42.0,2.0,5.0,13.0,,31.0,2.0,0.0,,,34.0,10.0,6.0,27.0,11.0,2.0,11.0,12.0,9.0,0.0,4.0,,17.0,2.0,20.0,2.0,,6.0,82.0,0.0,16.0,3.0,4.0,3.0,6.0,,2.0,3.0,2.0,3.0,2.0,2.0,8.0,23.0,2.0,2.0,13.0,22.0,10.0,25.0,0.0,0.0,5.0,3.0,70.0,2.0,3.0,0.0,0.0,1.0,0.0,98.0,0.0,4.0,,,27.0,,1.0,,,6.0,3.0,1.0,0.0,2.0,1.0,9.0,48.0,2.0,2.0,11.0,11.0,84.0,1.0,21.0,1.0,0.0,,7.0,1.0,0.0,49.0,179.0,,126.0,0.0,1.0,1.0,1.0,0.0,0.0,,0.0,6.0,6.0,18.0,3.0,0.0,,2.0,0.0
2024-02-14 00:00:00+00:00,145.0,,84.0,12.0,19.0,479.0,1.0,31.0,132.0,6.0,51.0,0.0,107.0,12.0,0.0,17.0,2.0,47.0,,3.0,0.0,5.0,10.0,46.0,3.0,5.0,10.0,,63.0,0.0,0.0,,,35.0,2.0,9.0,17.0,19.0,1.0,15.0,9.0,24.0,0.0,2.0,,22.0,1.0,25.0,4.0,,22.0,68.0,0.0,19.0,2.0,0.0,5.0,0.0,,0.0,0.0,1.0,3.0,3.0,4.0,3.0,13.0,2.0,5.0,10.0,47.0,6.0,20.0,1.0,0.0,3.0,0.0,513.0,3.0,2.0,1.0,0.0,0.0,0.0,91.0,0.0,2.0,,,25.0,,0.0,,,8.0,3.0,1.0,2.0,3.0,3.0,8.0,69.0,1.0,3.0,22.0,14.0,92.0,3.0,15.0,3.0,3.0,,15.0,1.0,1.0,59.0,197.0,,157.0,1.0,1.0,2.0,0.0,0.0,0.0,,0.0,5.0,9.0,22.0,6.0,1.0,,7.0,0.0
2024-02-15 00:00:00+00:00,203.0,,92.0,21.0,16.0,514.0,5.0,44.0,152.0,6.0,54.0,0.0,26.0,6.0,0.0,25.0,7.0,20.0,,6.0,0.0,1.0,10.0,48.0,6.0,4.0,3.0,,37.0,3.0,0.0,,,32.0,9.0,5.0,13.0,13.0,0.0,16.0,9.0,39.0,0.0,2.0,,28.0,0.0,27.0,2.0,,11.0,113.0,0.0,18.0,5.0,1.0,4.0,4.0,,2.0,2.0,1.0,4.0,3.0,3.0,4.0,35.0,0.0,0.0,37.0,20.0,12.0,27.0,1.0,2.0,5.0,3.0,243.0,1.0,0.0,4.0,0.0,0.0,0.0,101.0,0.0,4.0,,,22.0,,0.0,,,3.0,4.0,0.0,2.0,1.0,6.0,7.0,61.0,2.0,6.0,27.0,18.0,169.0,1.0,85.0,6.0,2.0,,9.0,0.0,1.0,59.0,226.0,,162.0,0.0,0.0,0.0,0.0,2.0,0.0,,1.0,8.0,15.0,26.0,2.0,0.0,,15.0,0.0
2024-02-16 00:00:00+00:00,135.0,,156.0,13.0,11.0,527.0,7.0,28.0,136.0,1.0,61.0,0.0,30.0,7.0,0.0,40.0,6.0,7.0,,2.0,0.0,4.0,13.0,25.0,5.0,3.0,10.0,,18.0,0.0,1.0,,,39.0,10.0,7.0,13.0,9.0,0.0,26.0,19.0,19.0,0.0,4.0,,18.0,3.0,32.0,2.0,,8.0,133.0,0.0,15.0,1.0,0.0,4.0,5.0,,11.0,2.0,0.0,5.0,1.0,5.0,2.0,26.0,3.0,0.0,12.0,7.0,11.0,16.0,3.0,3.0,11.0,26.0,170.0,8.0,4.0,2.0,2.0,0.0,0.0,83.0,0.0,3.0,,,41.0,,4.0,,,2.0,1.0,1.0,2.0,3.0,5.0,8.0,61.0,2.0,1.0,28.0,5.0,74.0,2.0,82.0,4.0,1.0,,2.0,0.0,0.0,81.0,179.0,,152.0,2.0,0.0,0.0,0.0,2.0,0.0,,0.0,14.0,13.0,27.0,2.0,0.0,,4.0,0.0
2024-02-17 00:00:00+00:00,114.0,,88.0,7.0,7.0,433.0,4.0,26.0,103.0,1.0,28.0,0.0,22.0,11.0,0.0,35.0,9.0,8.0,,4.0,0.0,0.0,6.0,27.0,3.0,9.0,6.0,,29.0,4.0,4.0,,,19.0,3.0,3.0,9.0,12.0,1.0,8.0,13.0,27.0,0.0,3.0,,20.0,1.0,18.0,5.0,,6.0,82.0,0.0,6.0,1.0,2.0,2.0,6.0,,7.0,0.0,0.0,0.0,3.0,2.0,5.0,40.0,5.0,0.0,9.0,8.0,5.0,25.0,1.0,0.0,7.0,3.0,97.0,2.0,0.0,6.0,6.0,0.0,0.0,94.0,0.0,1.0,,,39.0,,1.0,,,1.0,0.0,1.0,1.0,2.0,3.0,8.0,59.0,12.0,4.0,16.0,7.0,65.0,1.0,7.0,1.0,5.0,,4.0,0.0,1.0,45.0,154.0,,118.0,0.0,0.0,1.0,1.0,0.0,0.0,,0.0,2.0,6.0,22.0,0.0,0.0,,5.0,0.0
2024-02-18 00:00:00+00:00,111.0,,87.0,11.0,7.0,417.0,2.0,17.0,126.0,5.0,37.0,0.0,26.0,4.0,0.0,25.0,6.0,7.0,,0.0,0.0,0.0,4.0,60.0,12.0,3.0,9.0,,17.0,9.0,4.0,,,34.0,4.0,1.0,10.0,7.0,0.0,25.0,23.0,30.0,0.0,2.0,,7.0,0.0,16.0,3.0,,10.0,61.0,0.0,15.0,0.0,6.0,6.0,3.0,,8.0,0.0,2.0,4.0,1.0,10.0,3.0,27.0,2.0,0.0,2.0,7.0,5.0,22.0,0.0,0.0,4.0,2.0,142.0,0.0,0.0,2.0,10.0,0.0,0.0,74.0,0.0,3.0,,,30.0,,1.0,,,0.0,2.0,1.0,3.0,0.0,0.0,3.0,47.0,26.0,5.0,20.0,3.0,57.0,3.0,69.0,5.0,3.0,,5.0,0.0,0.0,36.0,175.0,,135.0,0.0,0.0,0.0,1.0,0.0,0.0,,0.0,3.0,2.0,10.0,5.0,0.0,,17.0,0.0
2024-02-19 00:00:00+00:00,116.0,,90.0,22.0,24.0,453.0,24.0,33.0,108.0,3.0,30.0,0.0,29.0,13.0,0.0,24.0,6.0,9.0,,6.0,0.0,1.0,12.0,31.0,8.0,5.0,9.0,,34.0,1.0,1.0,,,46.0,8.0,6.0,15.0,11.0,1.0,27.0,14.0,21.0,0.0,2.0,,22.0,0.0,26.0,0.0,,6.0,69.0,0.0,10.0,4.0,0.0,2.0,2.0,,7.0,1.0,3.0,1.0,1.0,10.0,7.0,14.0,5.0,1.0,9.0,9.0,16.0,19.0,3.0,1.0,6.0,15.0,152.0,4.0,2.0,3.0,13.0,0.0,0.0,90.0,0.0,2.0,,,66.0,,0.0,,,2.0,1.0,2.0,0.0,6.0,2.0,4.0,46.0,15.0,3.0,13.0,20.0,68.0,0.0,64.0,1.0,4.0,,9.0,0.0,4.0,46.0,156.0,,114.0,1.0,0.0,2.0,1.0,3.0,0.0,,3.0,7.0,4.0,16.0,1.0,0.0,,19.0,0.0
2024-02-20 00:00:00+00:00,115.0,,64.0,12.0,17.0,538.0,29.0,44.0,103.0,2.0,48.0,1.0,42.0,9.0,0.0,13.0,9.0,9.0,,4.0,0.0,4.0,9.0,15.0,7.0,4.0,13.0,,13.0,0.0,2.0,,,51.0,2.0,5.0,15.0,8.0,0.0,16.0,12.0,15.0,0.0,6.0,,26.0,0.0,30.0,4.0,,6.0,74.0,0.0,13.0,3.0,9.0,4.0,0.0,,3.0,1.0,1.0,1.0,4.0,5.0,0.0,21.0,4.0,0.0,10.0,9.0,13.0,22.0,2.0,0.0,3.0,7.0,405.0,2.0,1.0,2.0,1.0,0.0,0.0,91.0,0.0,2.0,,,33.0,,4.0,,,4.0,0.0,1.0,1.0,1.0,6.0,5.0,53.0,4.0,4.0,21.0,14.0,97.0,2.0,22.0,2.0,4.0,,4.0,0.0,0.0,36.0,185.0,,132.0,1.0,0.0,0.0,0.0,0.0,0.0,,1.0,17.0,6.0,4.0,3.0,1.0,,3.0,0.0
2024-02-21 00:00:00+00:00,145.0,,77.0,30.0,11.0,487.0,9.0,31.0,59.0,4.0,33.0,5.0,34.0,8.0,0.0,50.0,12.0,12.0,,5.0,0.0,2.0,16.0,41.0,24.0,4.0,16.0,,167.0,5.0,3.0,,,33.0,2.0,5.0,6.0,6.0,2.0,17.0,11.0,19.0,0.0,5.0,,41.0,0.0,22.0,7.0,,4.0,110.0,0.0,17.0,1.0,3.0,6.0,2.0,,3.0,0.0,1.0,4.0,3.0,12.0,8.0,26.0,3.0,0.0,4.0,12.0,1.0,19.0,0.0,2.0,5.0,3.0,225.0,2.0,1.0,2.0,6.0,0.0,0.0,107.0,1.0,2.0,,,23.0,,1.0,,,4.0,2.0,2.0,1.0,1.0,2.0,3.0,38.0,1.0,8.0,32.0,4.0,60.0,2.0,19.0,5.0,1.0,,2.0,0.0,1.0,43.0,193.0,,140.0,0.0,0.0,0.0,0.0,1.0,1.0,,0.0,6.0,32.0,3.0,2.0,1.0,,2.0,1.0
2024-02-22 00:00:00+00:00,132.0,,91.0,30.0,46.0,490.0,10.0,44.0,92.0,4.0,39.0,1.0,24.0,13.0,0.0,17.0,15.0,7.0,,2.0,0.0,6.0,5.0,51.0,16.0,7.0,9.0,,184.0,4.0,7.0,,,22.0,3.0,8.0,16.0,7.0,3.0,9.0,6.0,29.0,0.0,4.0,,26.0,0.0,33.0,1.0,,2.0,150.0,1.0,64.0,3.0,6.0,6.0,0.0,,5.0,2.0,1.0,19.0,7.0,12.0,2.0,52.0,5.0,0.0,4.0,7.0,1.0,23.0,0.0,0.0,4.0,18.0,117.0,3.0,3.0,2.0,9.0,0.0,0.0,97.0,0.0,3.0,,,65.0,,2.0,,,7.0,4.0,6.0,2.0,2.0,8.0,6.0,44.0,0.0,3.0,34.0,8.0,72.0,5.0,1.0,0.0,2.0,,2.0,0.0,2.0,47.0,186.0,,149.0,0.0,1.0,0.0,2.0,0.0,0.0,,0.0,18.0,11.0,3.0,3.0,2.0,,0.0,0.0
2024-02-23 00:00:00+00:00,154.0,,406.0,32.0,17.0,483.0,10.0,31.0,120.0,7.0,32.0,7.0,25.0,13.0,0.0,13.0,15.0,21.0,,1.0,0.0,4.0,9.0,41.0,13.0,1.0,8.0,,169.0,3.0,2.0,,,43.0,5.0,6.0,25.0,5.0,2.0,3.0,9.0,22.0,0.0,0.0,,14.0,0.0,24.0,1.0,,3.0,168.0,0.0,39.0,1.0,1.0,2.0,1.0,,8.0,6.0,1.0,1.0,8.0,13.0,2.0,19.0,4.0,4.0,4.0,21.0,20.0,19.0,1.0,0.0,3.0,5.0,144.0,0.0,1.0,0.0,21.0,0.0,0.0,103.0,0.0,6.0,,,40.0,,0.0,,,1.0,1.0,6.0,1.0,7.0,9.0,8.0,50.0,1.0,4.0,22.0,6.0,71.0,2.0,20.0,4.0,4.0,,11.0,0.0,1.0,42.0,190.0,,134.0,0.0,2.0,0.0,0.0,1.0,0.0,,1.0,9.0,9.0,7.0,5.0,3.0,,25.0,0.0
2024-02-24 00:00:00+00:00,116.0,,336.0,17.0,14.0,426.0,4.0,41.0,59.0,5.0,50.0,1.0,19.0,7.0,1.0,35.0,13.0,38.0,,1.0,0.0,4.0,40.0,26.0,3.0,0.0,23.0,,53.0,2.0,19.0,,,16.0,5.0,3.0,62.0,21.0,0.0,17.0,11.0,11.0,0.0,2.0,,32.0,2.0,28.0,0.0,,5.0,72.0,0.0,19.0,1.0,4.0,0.0,4.0,,2.0,1.0,1.0,0.0,11.0,4.0,3.0,23.0,2.0,3.0,4.0,38.0,6.0,16.0,0.0,1.0,3.0,4.0,55.0,2.0,0.0,2.0,16.0,0.0,0.0,96.0,0.0,1.0,,,24.0,,0.0,,,0.0,5.0,2.0,1.0,1.0,7.0,6.0,62.0,0.0,2.0,19.0,15.0,96.0,2.0,26.0,5.0,2.0,,2.0,0.0,4.0,40.0,170.0,,123.0,1.0,1.0,2.0,3.0,0.0,0.0,,1.0,2.0,0.0,4.0,1.0,0.0,,15.0,0.0
2024-02-25 00:00:00+00:00,113.0,,151.0,18.0,17.0,458.0,4.0,32.0,70.0,4.0,48.0,0.0,29.0,2.0,1.0,38.0,21.0,15.0,,1.0,0.0,3.0,11.0,15.0,7.0,0.0,22.0,,25.0,1.0,2.0,,,27.0,4.0,5.0,19.0,13.0,0.0,26.0,13.0,18.0,0.0,0.0,,30.0,1.0,20.0,1.0,,5.0,84.0,0.0,29.0,0.0,1.0,1.0,5.0,,4.0,0.0,0.0,2.0,6.0,13.0,5.0,31.0,0.0,0.0,7.0,15.0,8.0,24.0,2.0,2.0,5.0,8.0,78.0,1.0,0.0,4.0,2.0,0.0,0.0,79.0,0.0,2.0,,,24.0,,3.0,,,0.0,2.0,2.0,0.0,4.0,5.0,0.0,56.0,0.0,1.0,15.0,6.0,75.0,3.0,4.0,3.0,2.0,,8.0,0.0,3.0,40.0,187.0,,142.0,0.0,0.0,0.0,1.0,1.0,0.0,,0.0,3.0,7.0,19.0,1.0,2.0,,14.0,0.0
2024-02-26 00:00:00+00:00,126.0,,192.0,28.0,20.0,535.0,7.0,21.0,120.0,9.0,69.0,2.0,38.0,17.0,1.0,59.0,21.0,21.0,,4.0,0.0,5.0,9.0,25.0,1.0,4.0,15.0,,29.0,3.0,1.0,,,38.0,15.0,2.0,22.0,5.0,2.0,25.0,8.0,16.0,0.0,1.0,,12.0,2.0,17.0,2.0,,4.0,127.0,0.0,19.0,1.0,8.0,3.0,1.0,,2.0,0.0,5.0,3.0,9.0,8.0,5.0,22.0,1.0,9.0,6.0,21.0,6.0,26.0,2.0,1.0,6.0,11.0,68.0,6.0,0.0,26.0,10.0,0.0,0.0,75.0,0.0,9.0,,,31.0,,1.0,,,3.0,0.0,5.0,0.0,3.0,2.0,4.0,70.0,0.0,2.0,11.0,11.0,79.0,4.0,4.0,3.0,5.0,,10.0,2.0,1.0,51.0,153.0,,142.0,1.0,0.0,1.0,1.0,0.0,1.0,,0.0,7.0,7.0,52.0,4.0,3.0,,8.0,1.0
2024-02-27 00:00:00+00:00,128.0,,157.0,28.0,20.0,630.0,4.0,35.0,104.0,5.0,34.0,0.0,120.0,10.0,5.0,26.0,20.0,9.0,,4.0,0.0,3.0,3.0,45.0,6.0,9.0,8.0,,25.0,1.0,1.0,,,36.0,5.0,5.0,22.0,13.0,0.0,14.0,3.0,41.0,0.0,7.0,,4.0,1.0,30.0,2.0,,12.0,183.0,1.0,16.0,4.0,4.0,5.0,3.0,,5.0,0.0,3.0,4.0,7.0,3.0,3.0,34.0,1.0,5.0,7.0,9.0,7.0,26.0,3.0,1.0,5.0,4.0,66.0,2.0,0.0,20.0,22.0,0.0,0.0,87.0,0.0,7.0,,,47.0,,1.0,,,3.0,2.0,5.0,0.0,2.0,3.0,5.0,55.0,3.0,0.0,46.0,14.0,77.0,2.0,7.0,4.0,0.0,,10.0,2.0,1.0,30.0,232.0,,151.0,0.0,0.0,1.0,4.0,2.0,0.0,,3.0,7.0,18.0,19.0,3.0,2.0,,5.0,0.0
2024-02-28 00:00:00+00:00,236.0,,155.0,26.0,12.0,728.0,3.0,47.0,145.0,0.0,51.0,22.0,41.0,9.0,3.0,29.0,13.0,13.0,,3.0,0.0,5.0,6.0,20.0,2.0,7.0,27.0,,19.0,2.0,7.0,,,55.0,5.0,3.0,26.0,19.0,0.0,40.0,5.0,25.0,0.0,1.0,,7.0,0.0,23.0,1.0,,8.0,168.0,0.0,21.0,3.0,3.0,4.0,7.0,,4.0,0.0,2.0,8.0,12.0,8.0,2.0,18.0,1.0,3.0,11.0,13.0,15.0,15.0,2.0,2.0,1.0,2.0,96.0,4.0,4.0,7.0,9.0,0.0,0.0,137.0,0.0,3.0,,,33.0,,6.0,,,0.0,4.0,0.0,1.0,1.0,4.0,13.0,97.0,6.0,2.0,112.0,15.0,54.0,2.0,27.0,7.0,2.0,,11.0,0.0,5.0,74.0,291.0,,211.0,3.0,0.0,0.0,4.0,0.0,0.0,,2.0,7.0,12.0,16.0,7.0,10.0,,6.0,0.0
2024-02-29 00:00:00+00:00,233.0,,151.0,17.0,36.0,625.0,4.0,49.0,126.0,3.0,71.0,9.0,36.0,12.0,2.0,45.0,15.0,5.0,,3.0,0.0,2.0,6.0,21.0,0.0,4.0,13.0,,22.0,3.0,3.0,,,29.0,11.0,6.0,44.0,13.0,1.0,29.0,8.0,38.0,0.0,1.0,,12.0,3.0,19.0,1.0,,3.0,119.0,0.0,55.0,0.0,2.0,3.0,14.0,,1.0,0.0,2.0,3.0,3.0,12.0,5.0,25.0,4.0,4.0,19.0,5.0,13.0,28.0,2.0,3.0,1.0,3.0,78.0,10.0,2.0,5.0,28.0,0.0,0.0,142.0,0.0,3.0,,,38.0,,0.0,,,2.0,0.0,0.0,2.0,2.0,7.0,8.0,73.0,1.0,0.0,30.0,17.0,83.0,5.0,40.0,5.0,4.0,,3.0,0.0,1.0,65.0,264.0,,200.0,3.0,1.0,3.0,0.0,1.0,0.0,,0.0,9.0,12.0,26.0,2.0,1.0,,5.0,0.0
2024-03-01 00:00:00+00:00,173.0,,148.0,8.0,44.0,577.0,2.0,46.0,126.0,3.0,47.0,4.0,34.0,15.0,1.0,25.0,11.0,33.0,,4.0,0.0,5.0,11.0,27.0,4.0,5.0,13.0,,35.0,4.0,6.0,,,45.0,10.0,6.0,29.0,17.0,2.0,27.0,16.0,22.0,0.0,0.0,,15.0,7.0,37.0,2.0,,2.0,124.0,1.0,61.0,1.0,2.0,5.0,4.0,,8.0,0.0,3.0,2.0,1.0,18.0,1.0,19.0,4.0,0.0,6.0,33.0,12.0,20.0,4.0,1.0,1.0,3.0,82.0,9.0,0.0,1.0,30.0,0.0,0.0,95.0,0.0,3.0,,,27.0,,4.0,,,2.0,5.0,2.0,1.0,2.0,5.0,11.0,74.0,0.0,0.0,54.0,3.0,87.0,2.0,16.0,2.0,1.0,,8.0,0.0,4.0,54.0,251.0,,160.0,2.0,1.0,1.0,0.0,0.0,0.0,,1.0,6.0,6.0,9.0,5.0,1.0,,6.0,0.0
2024-03-02 00:00:00+00:00,189.0,,184.0,22.0,19.0,587.0,4.0,35.0,77.0,2.0,47.0,0.0,17.0,5.0,2.0,32.0,8.0,12.0,,1.0,0.0,4.0,12.0,19.0,4.0,1.0,8.0,,18.0,4.0,2.0,,,23.0,12.0,4.0,24.0,14.0,0.0,46.0,10.0,41.0,0.0,4.0,,11.0,4.0,13.0,0.0,,10.0,75.0,0.0,28.0,1.0,4.0,9.0,6.0,,1.0,0.0,0.0,1.0,1.0,20.0,4.0,29.0,1.0,6.0,7.0,12.0,4.0,21.0,3.0,1.0,8.0,2.0,47.0,9.0,0.0,6.0,27.0,0.0,0.0,107.0,1.0,7.0,,,34.0,,3.0,,,0.0,3.0,5.0,0.0,4.0,3.0,3.0,57.0,0.0,11.0,48.0,5.0,98.0,7.0,6.0,0.0,1.0,,10.0,0.0,0.0,58.0,281.0,,175.0,1.0,0.0,2.0,0.0,0.0,0.0,,1.0,2.0,5.0,14.0,3.0,0.0,,1.0,0.0
2024-03-03 00:00:00+00:00,124.0,,184.0,35.0,18.0,561.0,5.0,50.0,71.0,4.0,59.0,1.0,29.0,13.0,0.0,28.0,29.0,6.0,,1.0,0.0,21.0,12.0,28.0,2.0,1.0,19.0,,34.0,0.0,3.0,,,19.0,6.0,3.0,19.0,11.0,0.0,44.0,4.0,28.0,0.0,1.0,,8.0,2.0,11.0,2.0,,0.0,110.0,0.0,18.0,0.0,0.0,3.0,3.0,,3.0,0.0,3.0,3.0,11.0,14.0,4.0,23.0,2.0,3.0,10.0,6.0,7.0,26.0,2.0,2.0,8.0,8.0,65.0,10.0,6.0,4.0,11.0,0.0,0.0,114.0,0.0,8.0,,,35.0,,3.0,,,1.0,2.0,2.0,0.0,4.0,7.0,6.0,67.0,9.0,5.0,33.0,26.0,89.0,3.0,1.0,4.0,2.0,,4.0,0.0,0.0,49.0,245.0,,159.0,1.0,1.0,2.0,3.0,0.0,1.0,,0.0,3.0,1.0,5.0,3.0,1.0,,2.0,0.0
2024-03-04 00:00:00+00:00,232.0,,297.0,35.0,10.0,673.0,10.0,56.0,96.0,6.0,70.0,1.0,30.0,10.0,1.0,27.0,24.0,23.0,,3.0,0.0,2.0,8.0,60.0,3.0,3.0,13.0,,49.0,2.0,5.0,,,49.0,17.0,10.0,23.0,17.0,0.0,48.0,7.0,46.0,0.0,1.0,,9.0,0.0,28.0,2.0,,2.0,90.0,0.0,16.0,1.0,0.0,6.0,5.0,,1.0,0.0,0.0,1.0,10.0,12.0,3.0,25.0,1.0,8.0,19.0,23.0,3.0,19.0,4.0,2.0,8.0,1.0,92.0,5.0,3.0,4.0,16.0,0.0,0.0,131.0,2.0,6.0,,,17.0,,3.0,,,0.0,2.0,2.0,2.0,5.0,11.0,8.0,78.0,2.0,1.0,26.0,13.0,65.0,5.0,9.0,6.0,1.0,,16.0,0.0,0.0,67.0,308.0,,179.0,0.0,1.0,2.0,1.0,0.0,0.0,,0.0,8.0,4.0,9.0,2.0,1.0,,6.0,0.0
2024-03-05 00:00:00+00:00,208.0,,234.0,27.0,11.0,778.0,7.0,48.0,105.0,6.0,85.0,0.0,14.0,6.0,1.0,39.0,22.0,24.0,,9.0,0.0,2.0,13.0,33.0,4.0,4.0,15.0,,42.0,4.0,11.0,,,47.0,14.0,12.0,27.0,13.0,0.0,42.0,6.0,48.0,0.0,3.0,,19.0,4.0,29.0,7.0,,3.0,98.0,0.0,30.0,0.0,2.0,7.0,3.0,,2.0,1.0,2.0,9.0,5.0,9.0,4.0,33.0,12.0,10.0,16.0,24.0,9.0,25.0,2.0,1.0,6.0,2.0,123.0,5.0,1.0,3.0,35.0,0.0,0.0,120.0,0.0,6.0,,,29.0,,5.0,,,2.0,3.0,2.0,2.0,13.0,7.0,17.0,97.0,2.0,0.0,37.0,16.0,77.0,5.0,2.0,1.0,7.0,,21.0,0.0,8.0,59.0,376.0,,193.0,3.0,1.0,4.0,0.0,1.0,0.0,,4.0,9.0,7.0,11.0,3.0,0.0,,1.0,0.0
2024-03-06 00:00:00+00:00,188.0,,267.0,28.0,16.0,709.0,7.0,48.0,105.0,3.0,84.0,2.0,20.0,17.0,0.0,38.0,18.0,14.0,,6.0,1.0,6.0,19.0,47.0,5.0,1.0,18.0,,85.0,6.0,6.0,,,49.0,29.0,13.0,23.0,16.0,0.0,30.0,7.0,23.0,0.0,4.0,,17.0,6.0,36.0,2.0,,3.0,126.0,0.0,23.0,0.0,1.0,4.0,5.0,,3.0,0.0,4.0,6.0,11.0,21.0,0.0,30.0,5.0,4.0,9.0,14.0,5.0,26.0,3.0,2.0,1.0,2.0,115.0,4.0,4.0,4.0,26.0,0.0,0.0,90.0,0.0,7.0,,,32.0,,1.0,,,3.0,6.0,4.0,1.0,20.0,13.0,12.0,92.0,2.0,5.0,32.0,11.0,87.0,4.0,4.0,2.0,0.0,,7.0,0.0,3.0,32.0,322.0,,196.0,2.0,0.0,0.0,19.0,1.0,1.0,,1.0,5.0,8.0,10.0,4.0,0.0,,4.0,0.0
2024-03-07 00:00:00+00:00,202.0,,240.0,18.0,8.0,688.0,5.0,38.0,155.0,3.0,98.0,8.0,31.0,9.0,0.0,57.0,26.0,14.0,,4.0,0.0,10.0,12.0,18.0,0.0,4.0,12.0,,23.0,0.0,3.0,,,57.0,7.0,5.0,18.0,14.0,2.0,28.0,6.0,39.0,0.0,2.0,,18.0,2.0,27.0,1.0,,3.0,126.0,0.0,22.0,3.0,5.0,7.0,7.0,,4.0,7.0,1.0,5.0,6.0,18.0,0.0,20.0,6.0,5.0,9.0,14.0,14.0,22.0,3.0,3.0,7.0,0.0,61.0,8.0,0.0,3.0,93.0,0.0,0.0,115.0,1.0,1.0,,,32.0,,2.0,,,5.0,2.0,3.0,0.0,14.0,7.0,10.0,72.0,4.0,3.0,19.0,15.0,90.0,3.0,3.0,3.0,2.0,,8.0,0.0,2.0,50.0,280.0,,201.0,1.0,0.0,1.0,17.0,1.0,0.0,,0.0,7.0,13.0,24.0,1.0,0.0,,7.0,0.0
2024-03-08 00:00:00+00:00,191.0,,155.0,20.0,21.0,635.0,19.0,56.0,112.0,5.0,88.0,13.0,24.0,7.0,0.0,108.0,28.0,20.0,,5.0,0.0,9.0,18.0,35.0,2.0,1.0,15.0,,17.0,5.0,2.0,,,46.0,3.0,13.0,17.0,7.0,0.0,28.0,7.0,35.0,0.0,2.0,,13.0,3.0,36.0,3.0,,5.0,253.0,0.0,17.0,1.0,5.0,9.0,4.0,,2.0,3.0,1.0,5.0,5.0,9.0,6.0,38.0,6.0,2.0,11.0,20.0,27.0,38.0,2.0,4.0,3.0,3.0,75.0,8.0,2.0,4.0,50.0,0.0,0.0,130.0,0.0,3.0,,,37.0,,1.0,,,0.0,1.0,2.0,1.0,4.0,5.0,8.0,82.0,1.0,3.0,19.0,11.0,88.0,4.0,3.0,3.0,2.0,,10.0,0.0,1.0,41.0,280.0,,186.0,0.0,3.0,4.0,7.0,0.0,0.0,,3.0,6.0,6.0,11.0,3.0,3.0,,18.0,0.0
2024-03-09 00:00:00+00:00,151.0,,162.0,10.0,10.0,554.0,12.0,71.0,76.0,5.0,101.0,2.0,10.0,4.0,0.0,35.0,16.0,3.0,,1.0,0.0,5.0,15.0,33.0,2.0,2.0,11.0,,14.0,3.0,2.0,,,38.0,23.0,4.0,21.0,14.0,0.0,15.0,6.0,23.0,0.0,2.0,,21.0,7.0,34.0,6.0,,8.0,114.0,0.0,21.0,0.0,3.0,8.0,6.0,,12.0,1.0,0.0,5.0,8.0,7.0,1.0,21.0,4.0,2.0,11.0,3.0,3.0,31.0,1.0,1.0,2.0,0.0,48.0,2.0,0.0,1.0,18.0,0.0,0.0,131.0,0.0,5.0,,,23.0,,1.0,,,1.0,3.0,8.0,5.0,1.0,8.0,6.0,82.0,0.0,0.0,39.0,10.0,139.0,3.0,3.0,2.0,2.0,,7.0,0.0,3.0,46.0,269.0,,152.0,3.0,1.0,1.0,1.0,1.0,0.0,,2.0,4.0,1.0,11.0,4.0,3.0,,15.0,0.0
2024-03-10 00:00:00+00:00,158.0,,148.0,35.0,7.0,689.0,2.0,66.0,65.0,2.0,107.0,0.0,19.0,1.0,0.0,48.0,17.0,4.0,,4.0,0.0,6.0,13.0,31.0,2.0,2.0,19.0,,18.0,2.0,1.0,,,39.0,15.0,3.0,12.0,10.0,1.0,83.0,0.0,24.0,0.0,1.0,,1.0,4.0,37.0,2.0,,3.0,145.0,1.0,20.0,3.0,1.0,4.0,3.0,,7.0,0.0,0.0,6.0,0.0,5.0,0.0,26.0,5.0,4.0,9.0,4.0,2.0,42.0,1.0,3.0,3.0,1.0,40.0,4.0,0.0,6.0,39.0,0.0,0.0,96.0,0.0,4.0,,,21.0,,0.0,,,1.0,2.0,3.0,0.0,1.0,2.0,15.0,65.0,2.0,1.0,20.0,6.0,111.0,1.0,3.0,1.0,1.0,,7.0,0.0,1.0,38.0,230.0,,173.0,1.0,1.0,3.0,9.0,2.0,15.0,,4.0,2.0,4.0,4.0,4.0,1.0,,4.0,0.0
2024-03-11 00:00:00+00:00,265.0,,191.0,20.0,8.0,721.0,8.0,86.0,111.0,4.0,84.0,5.0,58.0,6.0,0.0,67.0,37.0,22.0,,2.0,0.0,4.0,14.0,40.0,5.0,2.0,35.0,,48.0,4.0,5.0,,,29.0,18.0,7.0,18.0,20.0,3.0,152.0,4.0,52.0,0.0,7.0,,17.0,3.0,38.0,10.0,,5.0,125.0,0.0,19.0,4.0,2.0,4.0,2.0,,1.0,0.0,4.0,3.0,3.0,9.0,6.0,47.0,2.0,7.0,9.0,20.0,4.0,23.0,2.0,3.0,7.0,1.0,97.0,5.0,1.0,1.0,44.0,0.0,0.0,135.0,0.0,4.0,,,24.0,,5.0,,,0.0,4.0,3.0,1.0,3.0,14.0,17.0,103.0,0.0,0.0,23.0,13.0,138.0,6.0,6.0,2.0,1.0,,9.0,1.0,1.0,47.0,332.0,,196.0,0.0,1.0,1.0,9.0,1.0,1.0,,0.0,11.0,4.0,15.0,4.0,0.0,,5.0,0.0
2024-03-12 00:00:00+00:00,248.0,,187.0,30.0,11.0,737.0,12.0,85.0,229.0,9.0,88.0,2.0,20.0,4.0,1.0,112.0,14.0,22.0,,12.0,0.0,6.0,15.0,39.0,4.0,15.0,21.0,,21.0,5.0,1.0,,,20.0,27.0,11.0,30.0,10.0,0.0,34.0,5.0,31.0,0.0,0.0,,13.0,6.0,32.0,5.0,,7.0,138.0,1.0,22.0,4.0,2.0,11.0,1.0,,2.0,0.0,4.0,20.0,11.0,4.0,4.0,30.0,5.0,5.0,10.0,22.0,10.0,26.0,0.0,1.0,5.0,0.0,124.0,15.0,2.0,2.0,49.0,1.0,0.0,162.0,2.0,6.0,,,18.0,,3.0,,,4.0,2.0,5.0,2.0,4.0,11.0,19.0,92.0,2.0,6.0,15.0,21.0,142.0,7.0,21.0,0.0,1.0,,7.0,0.0,2.0,59.0,313.0,,206.0,1.0,2.0,1.0,1.0,0.0,1.0,,0.0,10.0,13.0,7.0,12.0,4.0,,1.0,0.0
2024-03-13 00:00:00+00:00,215.0,,174.0,35.0,7.0,708.0,6.0,96.0,131.0,3.0,100.0,1.0,29.0,8.0,0.0,133.0,22.0,18.0,,3.0,2.0,8.0,12.0,37.0,5.0,9.0,16.0,,38.0,5.0,4.0,,,32.0,13.0,12.0,24.0,21.0,0.0,41.0,7.0,28.0,0.0,2.0,,6.0,3.0,28.0,5.0,,3.0,138.0,0.0,17.0,0.0,1.0,12.0,2.0,,5.0,1.0,16.0,4.0,5.0,3.0,3.0,27.0,1.0,3.0,13.0,18.0,10.0,28.0,3.0,2.0,3.0,2.0,112.0,10.0,2.0,0.0,58.0,0.0,0.0,129.0,1.0,12.0,,,23.0,,7.0,,,3.0,8.0,6.0,12.0,1.0,7.0,25.0,77.0,3.0,0.0,25.0,21.0,110.0,5.0,47.0,2.0,0.0,,5.0,0.0,1.0,55.0,301.0,,189.0,1.0,1.0,1.0,8.0,1.0,3.0,,1.0,11.0,7.0,10.0,4.0,1.0,,0.0,0.0
2024-03-14 00:00:00+00:00,207.0,,154.0,24.0,9.0,664.0,9.0,71.0,122.0,5.0,134.0,0.0,15.0,9.0,2.0,77.0,27.0,17.0,,6.0,0.0,8.0,8.0,59.0,3.0,4.0,27.0,,26.0,3.0,2.0,,,47.0,14.0,7.0,30.0,17.0,0.0,117.0,5.0,28.0,0.0,0.0,,5.0,6.0,39.0,3.0,,1.0,102.0,0.0,26.0,2.0,2.0,8.0,7.0,,1.0,1.0,4.0,2.0,5.0,5.0,3.0,33.0,0.0,5.0,10.0,17.0,12.0,36.0,1.0,0.0,3.0,4.0,46.0,4.0,2.0,1.0,46.0,0.0,0.0,139.0,0.0,0.0,,,16.0,,9.0,,,2.0,3.0,3.0,4.0,4.0,10.0,13.0,79.0,2.0,0.0,28.0,15.0,138.0,4.0,5.0,6.0,0.0,,5.0,0.0,0.0,60.0,313.0,,166.0,1.0,2.0,2.0,2.0,0.0,5.0,,2.0,6.0,6.0,6.0,4.0,4.0,,0.0,0.0
2024-03-15 00:00:00+00:00,148.0,,136.0,17.0,3.0,583.0,7.0,45.0,74.0,1.0,163.0,1.0,17.0,4.0,2.0,51.0,13.0,21.0,,6.0,0.0,13.0,17.0,19.0,2.0,16.0,42.0,,11.0,2.0,2.0,,,28.0,21.0,7.0,102.0,6.0,0.0,32.0,5.0,22.0,0.0,0.0,,2.0,9.0,36.0,2.0,,4.0,97.0,1.0,34.0,4.0,3.0,6.0,9.0,,4.0,2.0,3.0,2.0,6.0,7.0,2.0,36.0,1.0,6.0,10.0,21.0,8.0,31.0,1.0,1.0,3.0,2.0,62.0,5.0,3.0,2.0,36.0,0.0,0.0,130.0,0.0,5.0,,,22.0,,7.0,,,2.0,0.0,6.0,4.0,3.0,9.0,15.0,96.0,2.0,5.0,15.0,13.0,107.0,2.0,2.0,1.0,0.0,,10.0,0.0,2.0,54.0,279.0,,161.0,0.0,1.0,3.0,0.0,0.0,15.0,,0.0,9.0,10.0,6.0,7.0,0.0,,7.0,0.0
2024-03-16 00:00:00+00:00,173.0,,156.0,12.0,5.0,526.0,3.0,43.0,103.0,2.0,199.0,0.0,56.0,2.0,0.0,39.0,17.0,9.0,,2.0,0.0,4.0,13.0,23.0,2.0,23.0,15.0,,16.0,2.0,0.0,,,8.0,6.0,8.0,49.0,13.0,0.0,25.0,2.0,26.0,0.0,0.0,,13.0,5.0,16.0,0.0,,3.0,44.0,2.0,18.0,0.0,1.0,9.0,4.0,,2.0,16.0,0.0,3.0,2.0,6.0,4.0,32.0,1.0,5.0,12.0,9.0,8.0,28.0,2.0,0.0,7.0,0.0,47.0,5.0,0.0,3.0,29.0,0.0,0.0,118.0,0.0,4.0,,,16.0,,1.0,,,1.0,2.0,3.0,2.0,1.0,5.0,13.0,83.0,1.0,3.0,16.0,10.0,122.0,1.0,2.0,6.0,2.0,,5.0,2.0,0.0,43.0,257.0,,158.0,4.0,2.0,3.0,2.0,0.0,2.0,,0.0,3.0,2.0,2.0,1.0,0.0,,1.0,0.0
2024-03-17 00:00:00+00:00,120.0,,130.0,9.0,4.0,535.0,0.0,51.0,71.0,2.0,217.0,0.0,29.0,5.0,0.0,34.0,10.0,8.0,,1.0,0.0,6.0,7.0,28.0,2.0,15.0,14.0,,13.0,2.0,2.0,,,40.0,5.0,13.0,37.0,11.0,1.0,16.0,2.0,26.0,0.0,2.0,,5.0,1.0,26.0,1.0,,2.0,34.0,0.0,25.0,0.0,2.0,9.0,0.0,,3.0,5.0,0.0,4.0,0.0,7.0,2.0,23.0,1.0,7.0,8.0,8.0,15.0,33.0,0.0,0.0,5.0,0.0,53.0,4.0,1.0,4.0,108.0,0.0,0.0,127.0,0.0,7.0,,,16.0,,6.0,,,3.0,2.0,3.0,0.0,0.0,4.0,17.0,95.0,0.0,0.0,23.0,13.0,128.0,3.0,3.0,1.0,6.0,,8.0,0.0,0.0,51.0,260.0,,160.0,6.0,0.0,4.0,1.0,0.0,8.0,,0.0,7.0,2.0,25.0,0.0,1.0,,2.0,0.0
2024-03-18 00:00:00+00:00,241.0,,147.0,18.0,6.0,618.0,8.0,57.0,74.0,10.0,380.0,1.0,38.0,28.0,1.0,46.0,9.0,16.0,,3.0,0.0,5.0,16.0,19.0,6.0,28.0,13.0,,6.0,3.0,4.0,,,34.0,3.0,8.0,20.0,12.0,1.0,51.0,2.0,28.0,0.0,0.0,,5.0,11.0,25.0,4.0,,4.0,127.0,0.0,18.0,1.0,4.0,5.0,0.0,,1.0,1.0,5.0,6.0,5.0,7.0,2.0,37.0,2.0,3.0,11.0,16.0,5.0,25.0,1.0,2.0,8.0,5.0,58.0,2.0,0.0,3.0,139.0,0.0,0.0,160.0,0.0,1.0,,,14.0,,2.0,,,7.0,3.0,3.0,2.0,5.0,16.0,15.0,118.0,1.0,0.0,30.0,27.0,111.0,2.0,3.0,6.0,1.0,,9.0,0.0,0.0,53.0,250.0,,197.0,3.0,1.0,1.0,0.0,0.0,9.0,,1.0,6.0,3.0,4.0,4.0,0.0,,10.0,0.0
2024-03-19 00:00:00+00:00,174.0,,122.0,19.0,17.0,578.0,9.0,43.0,93.0,3.0,304.0,1.0,23.0,12.0,1.0,63.0,18.0,14.0,,8.0,0.0,5.0,17.0,42.0,1.0,14.0,12.0,,11.0,6.0,2.0,,,20.0,6.0,19.0,21.0,17.0,1.0,50.0,5.0,30.0,0.0,4.0,,6.0,6.0,26.0,6.0,,3.0,83.0,1.0,15.0,0.0,5.0,7.0,1.0,,2.0,0.0,7.0,4.0,1.0,5.0,3.0,29.0,5.0,10.0,5.0,14.0,7.0,32.0,3.0,0.0,4.0,5.0,68.0,4.0,0.0,2.0,80.0,0.0,0.0,152.0,0.0,5.0,,,21.0,,2.0,,,2.0,1.0,2.0,0.0,7.0,15.0,11.0,94.0,6.0,0.0,54.0,12.0,109.0,4.0,3.0,3.0,0.0,,7.0,0.0,2.0,42.0,315.0,,155.0,0.0,3.0,2.0,2.0,0.0,2.0,,0.0,5.0,5.0,12.0,3.0,0.0,,2.0,0.0
2024-03-20 00:00:00+00:00,171.0,,133.0,18.0,66.0,628.0,5.0,41.0,92.0,8.0,160.0,8.0,33.0,16.0,4.0,63.0,16.0,16.0,,3.0,0.0,4.0,17.0,31.0,4.0,8.0,13.0,,9.0,5.0,2.0,,,34.0,5.0,10.0,22.0,14.0,2.0,22.0,2.0,28.0,0.0,1.0,,8.0,16.0,29.0,6.0,,3.0,59.0,0.0,18.0,3.0,2.0,7.0,1.0,,1.0,0.0,4.0,6.0,4.0,4.0,4.0,32.0,13.0,2.0,10.0,16.0,3.0,27.0,0.0,0.0,6.0,4.0,64.0,5.0,4.0,5.0,36.0,0.0,0.0,132.0,0.0,5.0,,,24.0,,3.0,,,19.0,2.0,4.0,1.0,1.0,22.0,9.0,82.0,1.0,1.0,24.0,18.0,147.0,2.0,4.0,4.0,4.0,,7.0,0.0,1.0,58.0,264.0,,141.0,3.0,1.0,0.0,4.0,0.0,3.0,,0.0,13.0,15.0,4.0,6.0,1.0,,11.0,0.0
2024-03-21 00:00:00+00:00,175.0,,137.0,16.0,132.0,620.0,6.0,60.0,71.0,6.0,195.0,0.0,28.0,5.0,0.0,67.0,16.0,10.0,,4.0,0.0,1.0,5.0,22.0,4.0,4.0,25.0,,92.0,3.0,1.0,,,30.0,9.0,3.0,32.0,8.0,12.0,18.0,4.0,24.0,0.0,8.0,,16.0,13.0,34.0,6.0,,2.0,67.0,0.0,14.0,2.0,0.0,6.0,5.0,,2.0,1.0,1.0,1.0,2.0,4.0,3.0,34.0,15.0,1.0,9.0,10.0,9.0,20.0,0.0,1.0,4.0,5.0,41.0,6.0,1.0,1.0,30.0,0.0,0.0,150.0,0.0,4.0,,,26.0,,0.0,,,1.0,0.0,3.0,1.0,7.0,12.0,19.0,71.0,0.0,0.0,22.0,8.0,109.0,2.0,4.0,0.0,4.0,,10.0,0.0,1.0,73.0,249.0,,147.0,0.0,1.0,1.0,3.0,1.0,2.0,,1.0,7.0,15.0,1.0,1.0,0.0,,4.0,0.0
2024-03-22 00:00:00+00:00,156.0,,120.0,16.0,77.0,541.0,7.0,49.0,97.0,4.0,105.0,9.0,19.0,9.0,1.0,29.0,5.0,9.0,,5.0,0.0,5.0,10.0,54.0,11.0,5.0,13.0,,125.0,2.0,3.0,,,48.0,3.0,11.0,25.0,17.0,7.0,42.0,6.0,29.0,0.0,3.0,,12.0,15.0,33.0,5.0,,10.0,98.0,0.0,21.0,7.0,1.0,4.0,5.0,,2.0,0.0,3.0,4.0,3.0,4.0,2.0,32.0,4.0,3.0,5.0,9.0,10.0,12.0,1.0,1.0,1.0,1.0,57.0,4.0,2.0,3.0,20.0,0.0,0.0,140.0,0.0,6.0,,,19.0,,2.0,,,2.0,2.0,0.0,1.0,1.0,12.0,25.0,58.0,3.0,1.0,19.0,13.0,120.0,2.0,2.0,1.0,1.0,,8.0,0.0,0.0,37.0,244.0,,149.0,3.0,0.0,4.0,6.0,0.0,6.0,,3.0,11.0,8.0,3.0,1.0,0.0,,1.0,0.0
2024-03-23 00:00:00+00:00,117.0,,123.0,6.0,21.0,521.0,12.0,37.0,74.0,10.0,78.0,4.0,15.0,35.0,0.0,27.0,11.0,6.0,,3.0,0.0,2.0,10.0,18.0,4.0,9.0,12.0,,48.0,1.0,1.0,,,13.0,1.0,4.0,17.0,10.0,1.0,21.0,3.0,25.0,0.0,0.0,,3.0,19.0,22.0,3.0,,4.0,71.0,1.0,27.0,1.0,1.0,5.0,4.0,,3.0,0.0,4.0,4.0,4.0,1.0,2.0,22.0,4.0,0.0,8.0,6.0,3.0,17.0,0.0,2.0,6.0,6.0,44.0,2.0,0.0,5.0,85.0,0.0,0.0,105.0,0.0,6.0,,,10.0,,1.0,,,0.0,1.0,1.0,0.0,2.0,5.0,14.0,58.0,0.0,2.0,20.0,7.0,100.0,2.0,37.0,1.0,3.0,,9.0,0.0,0.0,38.0,191.0,,155.0,2.0,0.0,1.0,1.0,0.0,4.0,,0.0,8.0,5.0,0.0,2.0,3.0,,0.0,0.0
2024-03-24 00:00:00+00:00,160.0,,116.0,16.0,30.0,493.0,8.0,34.0,56.0,6.0,85.0,0.0,15.0,13.0,2.0,21.0,11.0,14.0,,1.0,0.0,0.0,8.0,27.0,2.0,3.0,11.0,,5.0,1.0,3.0,,,12.0,3.0,8.0,26.0,9.0,2.0,23.0,2.0,28.0,0.0,6.0,,9.0,33.0,29.0,2.0,,6.0,48.0,0.0,13.0,0.0,0.0,3.0,2.0,,0.0,2.0,1.0,3.0,2.0,2.0,5.0,28.0,11.0,5.0,1.0,13.0,3.0,26.0,1.0,0.0,1.0,1.0,51.0,10.0,0.0,1.0,38.0,0.0,0.0,118.0,0.0,7.0,,,15.0,,1.0,,,3.0,4.0,3.0,0.0,1.0,5.0,8.0,61.0,1.0,0.0,23.0,7.0,103.0,0.0,28.0,0.0,3.0,,2.0,0.0,0.0,51.0,171.0,,157.0,2.0,1.0,1.0,1.0,0.0,0.0,,0.0,2.0,2.0,3.0,5.0,0.0,,1.0,1.0
2024-03-25 00:00:00+00:00,205.0,,142.0,10.0,89.0,601.0,4.0,51.0,100.0,10.0,106.0,2.0,14.0,31.0,6.0,40.0,18.0,15.0,,5.0,0.0,3.0,6.0,15.0,2.0,6.0,5.0,,23.0,0.0,2.0,,,14.0,5.0,5.0,27.0,21.0,2.0,14.0,1.0,20.0,1.0,10.0,,3.0,25.0,13.0,5.0,,9.0,66.0,1.0,16.0,0.0,2.0,2.0,2.0,,1.0,2.0,3.0,6.0,4.0,4.0,3.0,34.0,11.0,5.0,7.0,15.0,4.0,37.0,3.0,3.0,4.0,1.0,43.0,3.0,1.0,1.0,27.0,0.0,0.0,155.0,0.0,5.0,,,13.0,,1.0,,,11.0,8.0,2.0,1.0,10.0,10.0,8.0,76.0,0.0,0.0,29.0,9.0,98.0,3.0,22.0,3.0,5.0,,7.0,0.0,0.0,84.0,231.0,,149.0,0.0,0.0,0.0,1.0,0.0,4.0,,4.0,4.0,5.0,4.0,4.0,0.0,,3.0,1.0
2024-03-26 00:00:00+00:00,285.0,,133.0,15.0,48.0,587.0,8.0,57.0,63.0,8.0,116.0,3.0,20.0,25.0,6.0,37.0,19.0,11.0,,6.0,1.0,3.0,11.0,19.0,3.0,5.0,8.0,,20.0,2.0,1.0,,,15.0,1.0,4.0,18.0,24.0,1.0,18.0,7.0,27.0,1.0,9.0,,13.0,31.0,28.0,1.0,,3.0,146.0,0.0,18.0,5.0,5.0,5.0,6.0,,2.0,3.0,0.0,2.0,1.0,4.0,7.0,28.0,8.0,6.0,8.0,11.0,1.0,24.0,0.0,1.0,4.0,1.0,65.0,4.0,3.0,1.0,99.0,0.0,0.0,137.0,0.0,2.0,,,12.0,,2.0,,,1.0,1.0,6.0,2.0,6.0,11.0,9.0,72.0,1.0,0.0,21.0,11.0,110.0,2.0,5.0,2.0,1.0,,6.0,0.0,0.0,56.0,235.0,,141.0,1.0,1.0,3.0,1.0,0.0,1.0,,15.0,5.0,26.0,4.0,4.0,0.0,,1.0,3.0
2024-03-27 00:00:00+00:00,218.0,,158.0,19.0,34.0,631.0,12.0,39.0,76.0,3.0,118.0,1.0,18.0,43.0,5.0,46.0,16.0,6.0,,8.0,0.0,2.0,14.0,21.0,3.0,25.0,5.0,,26.0,0.0,1.0,,,10.0,0.0,8.0,30.0,11.0,0.0,14.0,14.0,24.0,0.0,12.0,,9.0,12.0,36.0,2.0,,5.0,151.0,2.0,14.0,2.0,2.0,1.0,1.0,,1.0,2.0,1.0,3.0,3.0,1.0,5.0,27.0,6.0,2.0,8.0,6.0,0.0,26.0,4.0,0.0,1.0,7.0,46.0,3.0,0.0,2.0,53.0,0.0,0.0,137.0,0.0,2.0,,,10.0,,3.0,,,3.0,7.0,3.0,1.0,5.0,7.0,12.0,93.0,0.0,3.0,35.0,13.0,144.0,4.0,7.0,2.0,2.0,,3.0,0.0,0.0,44.0,255.0,,154.0,0.0,1.0,1.0,1.0,1.0,0.0,,0.0,7.0,15.0,1.0,4.0,0.0,,3.0,2.0
2024-03-28 00:00:00+00:00,267.0,,140.0,18.0,62.0,611.0,44.0,75.0,83.0,6.0,89.0,1.0,16.0,26.0,4.0,28.0,7.0,11.0,,5.0,0.0,3.0,7.0,28.0,2.0,11.0,9.0,,19.0,2.0,0.0,,,19.0,18.0,2.0,20.0,7.0,3.0,10.0,10.0,30.0,0.0,9.0,,13.0,4.0,26.0,2.0,,3.0,227.0,0.0,19.0,0.0,1.0,2.0,3.0,,3.0,1.0,0.0,7.0,6.0,6.0,2.0,32.0,8.0,6.0,3.0,11.0,7.0,24.0,1.0,0.0,6.0,9.0,74.0,5.0,1.0,6.0,66.0,0.0,0.0,168.0,0.0,5.0,,,11.0,,5.0,,,8.0,1.0,2.0,0.0,22.0,8.0,7.0,73.0,1.0,1.0,40.0,8.0,131.0,6.0,14.0,8.0,7.0,,5.0,1.0,2.0,40.0,250.0,,180.0,5.0,1.0,1.0,1.0,0.0,3.0,,0.0,9.0,8.0,5.0,3.0,0.0,,1.0,1.0
2024-03-29 00:00:00+00:00,162.0,,132.0,22.0,111.0,584.0,90.0,50.0,56.0,5.0,101.0,7.0,11.0,20.0,0.0,31.0,25.0,14.0,,5.0,0.0,2.0,7.0,19.0,2.0,6.0,19.0,,10.0,0.0,1.0,,,19.0,3.0,5.0,19.0,10.0,1.0,9.0,8.0,23.0,0.0,5.0,,14.0,13.0,28.0,2.0,,4.0,249.0,0.0,19.0,1.0,7.0,6.0,7.0,,5.0,1.0,1.0,9.0,2.0,6.0,5.0,27.0,7.0,1.0,4.0,14.0,18.0,28.0,2.0,0.0,3.0,7.0,68.0,2.0,0.0,6.0,14.0,0.0,0.0,136.0,0.0,5.0,,,12.0,,2.0,,,2.0,5.0,2.0,1.0,8.0,3.0,13.0,68.0,2.0,0.0,23.0,9.0,135.0,4.0,3.0,1.0,5.0,,6.0,1.0,0.0,34.0,212.0,,171.0,2.0,3.0,0.0,2.0,0.0,1.0,,0.0,6.0,0.0,6.0,1.0,2.0,,1.0,2.0
2024-03-30 00:00:00+00:00,108.0,,96.0,6.0,73.0,538.0,65.0,40.0,40.0,3.0,96.0,0.0,18.0,25.0,3.0,21.0,14.0,5.0,,1.0,0.0,1.0,3.0,39.0,2.0,7.0,23.0,,11.0,1.0,1.0,,,15.0,6.0,2.0,21.0,16.0,1.0,9.0,8.0,26.0,0.0,1.0,,19.0,9.0,28.0,2.0,,0.0,219.0,0.0,11.0,2.0,1.0,5.0,2.0,,2.0,1.0,3.0,3.0,3.0,9.0,6.0,22.0,6.0,3.0,9.0,5.0,7.0,30.0,0.0,1.0,0.0,13.0,32.0,4.0,3.0,4.0,7.0,0.0,0.0,117.0,0.0,4.0,,,8.0,,2.0,,,0.0,2.0,1.0,0.0,2.0,4.0,19.0,65.0,1.0,2.0,19.0,11.0,123.0,1.0,2.0,4.0,0.0,,4.0,0.0,1.0,38.0,209.0,,147.0,2.0,2.0,0.0,1.0,0.0,1.0,,20.0,5.0,1.0,1.0,0.0,1.0,,4.0,0.0
2024-03-31 00:00:00+00:00,104.0,,112.0,10.0,43.0,529.0,67.0,34.0,40.0,7.0,118.0,1.0,31.0,38.0,12.0,24.0,8.0,8.0,,1.0,0.0,2.0,7.0,23.0,1.0,4.0,14.0,,16.0,2.0,1.0,,,9.0,14.0,3.0,22.0,7.0,0.0,15.0,15.0,16.0,0.0,3.0,,7.0,2.0,18.0,10.0,,2.0,105.0,0.0,15.0,1.0,7.0,7.0,11.0,,0.0,1.0,1.0,3.0,1.0,9.0,3.0,41.0,5.0,19.0,2.0,8.0,3.0,28.0,1.0,0.0,2.0,4.0,40.0,4.0,0.0,6.0,13.0,0.0,0.0,102.0,0.0,3.0,,,15.0,,2.0,,,0.0,5.0,10.0,2.0,1.0,1.0,9.0,63.0,0.0,2.0,26.0,5.0,81.0,1.0,7.0,2.0,5.0,,8.0,0.0,0.0,31.0,221.0,,154.0,2.0,2.0,0.0,1.0,0.0,3.0,,6.0,6.0,1.0,2.0,4.0,3.0,,3.0,0.0
2024-04-01 00:00:00+00:00,153.0,,114.0,15.0,36.0,544.0,98.0,60.0,64.0,6.0,157.0,0.0,40.0,36.0,2.0,50.0,9.0,21.0,,3.0,0.0,4.0,5.0,13.0,4.0,9.0,7.0,,12.0,6.0,1.0,,,15.0,10.0,13.0,14.0,13.0,0.0,19.0,6.0,26.0,0.0,4.0,,8.0,3.0,23.0,12.0,,1.0,132.0,0.0,11.0,1.0,1.0,5.0,37.0,,1.0,6.0,6.0,1.0,5.0,9.0,0.0,27.0,4.0,2.0,3.0,21.0,3.0,28.0,1.0,0.0,2.0,7.0,45.0,2.0,0.0,7.0,24.0,0.0,0.0,131.0,0.0,6.0,,,13.0,,3.0,,,0.0,1.0,3.0,3.0,7.0,9.0,12.0,72.0,0.0,0.0,24.0,7.0,116.0,7.0,10.0,5.0,4.0,,11.0,0.0,0.0,54.0,265.0,,165.0,0.0,1.0,3.0,1.0,0.0,2.0,,2.0,10.0,8.0,2.0,5.0,10.0,,2.0,0.0
2024-04-02 00:00:00+00:00,118.0,,123.0,43.0,61.0,553.0,281.0,107.0,63.0,3.0,95.0,1.0,11.0,19.0,1.0,20.0,8.0,18.0,,5.0,0.0,2.0,2.0,24.0,5.0,3.0,6.0,,18.0,2.0,1.0,,,37.0,5.0,15.0,9.0,13.0,0.0,7.0,7.0,19.0,0.0,8.0,,9.0,2.0,25.0,5.0,,1.0,91.0,0.0,17.0,6.0,1.0,4.0,20.0,,4.0,1.0,2.0,1.0,1.0,4.0,6.0,22.0,11.0,6.0,7.0,18.0,3.0,23.0,3.0,0.0,3.0,3.0,42.0,1.0,1.0,3.0,8.0,0.0,0.0,137.0,0.0,3.0,,,20.0,,2.0,,,2.0,0.0,4.0,0.0,2.0,3.0,9.0,59.0,0.0,3.0,38.0,20.0,112.0,2.0,5.0,1.0,2.0,,4.0,1.0,1.0,60.0,274.0,,157.0,1.0,0.0,1.0,0.0,0.0,0.0,,0.0,13.0,3.0,7.0,7.0,1.0,,0.0,1.0
2024-04-03 00:00:00+00:00,134.0,,100.0,20.0,27.0,496.0,189.0,84.0,54.0,3.0,115.0,2.0,19.0,14.0,1.0,33.0,4.0,8.0,,2.0,0.0,4.0,5.0,41.0,2.0,2.0,10.0,,45.0,1.0,0.0,,,22.0,2.0,4.0,16.0,19.0,4.0,6.0,11.0,30.0,2.0,6.0,,9.0,5.0,30.0,3.0,,0.0,104.0,0.0,20.0,0.0,3.0,6.0,9.0,,1.0,5.0,1.0,14.0,8.0,5.0,2.0,21.0,2.0,1.0,5.0,8.0,0.0,34.0,1.0,1.0,5.0,1.0,45.0,6.0,3.0,5.0,39.0,14.0,0.0,122.0,0.0,5.0,,,7.0,,4.0,,,3.0,0.0,12.0,2.0,4.0,5.0,15.0,80.0,2.0,3.0,35.0,12.0,138.0,2.0,4.0,4.0,0.0,,16.0,0.0,0.0,48.0,245.0,,155.0,0.0,0.0,0.0,2.0,0.0,0.0,,0.0,5.0,13.0,10.0,7.0,0.0,,3.0,1.0
2024-04-04 00:00:00+00:00,101.0,,125.0,7.0,19.0,585.0,138.0,61.0,65.0,3.0,190.0,0.0,16.0,54.0,1.0,30.0,13.0,6.0,,2.0,0.0,1.0,17.0,37.0,1.0,2.0,6.0,,27.0,14.0,1.0,,,12.0,4.0,10.0,25.0,13.0,0.0,4.0,11.0,19.0,0.0,5.0,,3.0,2.0,24.0,2.0,,0.0,84.0,0.0,16.0,0.0,0.0,4.0,7.0,,1.0,1.0,6.0,5.0,4.0,3.0,14.0,17.0,6.0,7.0,9.0,6.0,2.0,32.0,1.0,0.0,4.0,10.0,71.0,2.0,5.0,5.0,22.0,3.0,0.0,103.0,1.0,11.0,,,11.0,,4.0,,,2.0,18.0,7.0,1.0,3.0,6.0,10.0,71.0,2.0,2.0,38.0,10.0,150.0,5.0,3.0,2.0,4.0,,13.0,0.0,0.0,62.0,218.0,,157.0,3.0,2.0,1.0,1.0,1.0,1.0,,2.0,6.0,16.0,21.0,4.0,0.0,,1.0,0.0
2024-04-05 00:00:00+00:00,136.0,,146.0,16.0,14.0,556.0,63.0,44.0,51.0,7.0,179.0,1.0,15.0,51.0,4.0,36.0,8.0,6.0,,3.0,0.0,0.0,5.0,27.0,5.0,7.0,8.0,,11.0,1.0,0.0,,,10.0,11.0,6.0,30.0,13.0,0.0,5.0,15.0,26.0,1.0,2.0,,10.0,3.0,23.0,2.0,,1.0,84.0,0.0,15.0,4.0,1.0,2.0,1.0,,2.0,1.0,0.0,3.0,4.0,7.0,4.0,15.0,6.0,3.0,5.0,6.0,5.0,28.0,0.0,0.0,4.0,10.0,47.0,0.0,0.0,2.0,18.0,0.0,0.0,113.0,0.0,4.0,,,14.0,,2.0,,,2.0,4.0,4.0,2.0,1.0,4.0,8.0,65.0,1.0,3.0,15.0,9.0,186.0,2.0,1.0,5.0,2.0,,4.0,0.0,0.0,51.0,246.0,,156.0,4.0,1.0,0.0,0.0,0.0,0.0,,0.0,2.0,5.0,4.0,1.0,0.0,,5.0,0.0
2024-04-06 00:00:00+00:00,123.0,,143.0,13.0,25.0,489.0,55.0,43.0,79.0,3.0,112.0,0.0,17.0,35.0,2.0,37.0,18.0,1.0,,1.0,0.0,1.0,6.0,4.0,1.0,3.0,5.0,,15.0,1.0,2.0,,,9.0,2.0,5.0,10.0,13.0,0.0,13.0,10.0,7.0,0.0,0.0,,8.0,2.0,13.0,3.0,,0.0,82.0,0.0,12.0,1.0,0.0,4.0,2.0,,0.0,0.0,0.0,3.0,1.0,1.0,2.0,10.0,2.0,4.0,5.0,1.0,4.0,35.0,0.0,0.0,4.0,5.0,41.0,4.0,0.0,1.0,45.0,0.0,0.0,113.0,0.0,5.0,,,19.0,,1.0,,,2.0,2.0,1.0,0.0,1.0,8.0,3.0,54.0,2.0,0.0,13.0,7.0,104.0,0.0,2.0,2.0,0.0,,14.0,2.0,1.0,47.0,181.0,,140.0,2.0,0.0,1.0,3.0,0.0,0.0,,0.0,3.0,4.0,0.0,0.0,1.0,,1.0,0.0
2024-04-07 00:00:00+00:00,83.0,,153.0,20.0,14.0,437.0,70.0,33.0,55.0,4.0,109.0,1.0,6.0,22.0,1.0,24.0,8.0,20.0,,0.0,0.0,3.0,11.0,6.0,2.0,1.0,6.0,,13.0,1.0,3.0,,,5.0,4.0,1.0,14.0,5.0,1.0,6.0,4.0,44.0,1.0,8.0,,5.0,2.0,29.0,3.0,,3.0,86.0,0.0,12.0,1.0,0.0,2.0,2.0,,1.0,0.0,0.0,4.0,3.0,3.0,4.0,13.0,2.0,3.0,5.0,20.0,1.0,33.0,2.0,1.0,5.0,7.0,36.0,2.0,0.0,1.0,17.0,0.0,0.0,112.0,0.0,1.0,,,16.0,,2.0,,,1.0,3.0,10.0,0.0,2.0,6.0,4.0,75.0,1.0,1.0,29.0,5.0,145.0,2.0,4.0,0.0,0.0,,15.0,0.0,0.0,53.0,171.0,,140.0,0.0,1.0,1.0,4.0,1.0,0.0,,0.0,3.0,10.0,0.0,5.0,3.0,,0.0,1.0
2024-04-08 00:00:00+00:00,158.0,,155.0,48.0,17.0,528.0,111.0,48.0,44.0,23.0,82.0,0.0,16.0,29.0,1.0,24.0,9.0,52.0,,3.0,0.0,2.0,37.0,34.0,0.0,6.0,14.0,,12.0,4.0,7.0,,,7.0,13.0,5.0,45.0,12.0,0.0,10.0,2.0,27.0,1.0,6.0,,18.0,4.0,23.0,4.0,,2.0,178.0,0.0,9.0,1.0,0.0,6.0,2.0,,2.0,0.0,2.0,4.0,2.0,2.0,12.0,18.0,3.0,1.0,4.0,52.0,0.0,42.0,2.0,1.0,4.0,4.0,30.0,1.0,2.0,6.0,38.0,0.0,0.0,123.0,1.0,3.0,,,17.0,,2.0,,,7.0,1.0,14.0,0.0,4.0,6.0,4.0,58.0,0.0,5.0,20.0,12.0,174.0,2.0,3.0,2.0,2.0,,7.0,4.0,0.0,80.0,229.0,,147.0,2.0,4.0,0.0,1.0,0.0,2.0,,0.0,8.0,5.0,1.0,6.0,0.0,,0.0,0.0
2024-04-09 00:00:00+00:00,186.0,,190.0,17.0,13.0,534.0,71.0,45.0,33.0,7.0,96.0,3.0,12.0,20.0,2.0,33.0,9.0,26.0,,4.0,1.0,3.0,21.0,27.0,0.0,6.0,5.0,,18.0,2.0,1.0,,,35.0,2.0,5.0,21.0,14.0,0.0,5.0,5.0,27.0,0.0,0.0,,9.0,1.0,25.0,2.0,,1.0,199.0,0.0,12.0,4.0,0.0,2.0,2.0,,0.0,0.0,2.0,1.0,3.0,4.0,7.0,13.0,6.0,5.0,4.0,26.0,0.0,34.0,1.0,0.0,4.0,9.0,52.0,5.0,0.0,1.0,3.0,0.0,0.0,139.0,0.0,6.0,,,8.0,,2.0,,,1.0,5.0,1.0,2.0,4.0,9.0,6.0,60.0,0.0,0.0,16.0,19.0,90.0,3.0,2.0,5.0,5.0,,5.0,14.0,2.0,54.0,203.0,,148.0,1.0,1.0,1.0,0.0,0.0,1.0,,0.0,4.0,5.0,1.0,8.0,1.0,,1.0,1.0
2024-04-10 00:00:00+00:00,158.0,,473.0,26.0,14.0,456.0,91.0,31.0,44.0,7.0,91.0,1.0,12.0,18.0,3.0,45.0,11.0,10.0,,2.0,0.0,4.0,18.0,20.0,1.0,6.0,6.0,,21.0,0.0,1.0,,,35.0,6.0,7.0,24.0,8.0,0.0,5.0,4.0,19.0,1.0,1.0,,5.0,1.0,28.0,2.0,,1.0,111.0,0.0,10.0,1.0,0.0,4.0,2.0,,0.0,1.0,3.0,2.0,1.0,5.0,4.0,23.0,1.0,2.0,6.0,10.0,2.0,33.0,1.0,0.0,3.0,23.0,45.0,3.0,1.0,6.0,17.0,0.0,0.0,117.0,0.0,2.0,,,13.0,,4.0,,,2.0,8.0,15.0,1.0,1.0,5.0,8.0,53.0,0.0,3.0,30.0,6.0,129.0,8.0,1.0,6.0,3.0,,4.0,8.0,0.0,41.0,234.0,,139.0,5.0,1.0,1.0,0.0,0.0,0.0,,1.0,4.0,9.0,0.0,3.0,1.0,,1.0,2.0
2024-04-11 00:00:00+00:00,248.0,,484.0,9.0,19.0,526.0,33.0,52.0,41.0,7.0,76.0,0.0,13.0,30.0,1.0,65.0,12.0,8.0,,8.0,0.0,1.0,16.0,30.0,0.0,1.0,7.0,,22.0,1.0,1.0,,,45.0,16.0,4.0,26.0,17.0,0.0,4.0,5.0,40.0,3.0,1.0,,13.0,1.0,21.0,3.0,,0.0,111.0,0.0,11.0,8.0,0.0,5.0,2.0,,2.0,2.0,1.0,2.0,2.0,3.0,7.0,15.0,1.0,4.0,7.0,8.0,1.0,31.0,1.0,0.0,3.0,3.0,35.0,2.0,0.0,6.0,15.0,0.0,0.0,130.0,0.0,4.0,,,23.0,,0.0,,,3.0,3.0,6.0,0.0,4.0,6.0,8.0,63.0,2.0,1.0,17.0,19.0,171.0,2.0,2.0,5.0,0.0,,5.0,3.0,2.0,72.0,184.0,,120.0,0.0,0.0,3.0,0.0,0.0,1.0,,1.0,1.0,6.0,1.0,2.0,0.0,,2.0,0.0
2024-04-12 00:00:00+00:00,204.0,,260.0,19.0,54.0,474.0,48.0,39.0,46.0,6.0,75.0,0.0,8.0,36.0,1.0,37.0,13.0,8.0,,10.0,0.0,2.0,9.0,28.0,3.0,5.0,7.0,,19.0,2.0,8.0,,,22.0,5.0,4.0,25.0,5.0,0.0,7.0,4.0,36.0,0.0,5.0,,16.0,4.0,23.0,5.0,,1.0,125.0,0.0,15.0,13.0,2.0,7.0,1.0,,1.0,0.0,2.0,12.0,4.0,11.0,3.0,24.0,2.0,2.0,7.0,8.0,4.0,30.0,3.0,3.0,8.0,7.0,48.0,4.0,1.0,4.0,23.0,0.0,0.0,105.0,0.0,6.0,,,19.0,,2.0,,,1.0,2.0,6.0,1.0,3.0,5.0,5.0,67.0,0.0,2.0,75.0,10.0,112.0,5.0,2.0,2.0,0.0,,5.0,1.0,0.0,57.0,236.0,,132.0,2.0,0.0,1.0,2.0,0.0,0.0,,2.0,8.0,4.0,3.0,3.0,1.0,,5.0,0.0
2024-04-13 00:00:00+00:00,116.0,,155.0,9.0,59.0,437.0,18.0,31.0,59.0,3.0,52.0,0.0,7.0,5.0,2.0,45.0,23.0,7.0,,2.0,0.0,3.0,4.0,38.0,2.0,4.0,4.0,,26.0,1.0,0.0,,,20.0,2.0,0.0,11.0,12.0,1.0,10.0,9.0,24.0,2.0,2.0,,4.0,0.0,17.0,3.0,,0.0,57.0,0.0,14.0,15.0,2.0,0.0,1.0,,0.0,0.0,1.0,8.0,4.0,1.0,4.0,15.0,1.0,0.0,6.0,7.0,4.0,18.0,2.0,0.0,5.0,1.0,87.0,0.0,0.0,6.0,20.0,0.0,0.0,97.0,0.0,3.0,,,16.0,,0.0,,,0.0,1.0,4.0,0.0,3.0,5.0,6.0,46.0,2.0,0.0,21.0,7.0,80.0,1.0,3.0,0.0,1.0,,6.0,2.0,0.0,35.0,234.0,,129.0,1.0,0.0,2.0,0.0,0.0,1.0,,3.0,4.0,0.0,2.0,3.0,1.0,,0.0,0.0
2024-04-14 00:00:00+00:00,103.0,,156.0,12.0,50.0,403.0,29.0,22.0,61.0,1.0,78.0,0.0,17.0,4.0,0.0,35.0,14.0,6.0,,0.0,0.0,2.0,4.0,19.0,2.0,3.0,5.0,,15.0,0.0,3.0,,,20.0,4.0,3.0,17.0,4.0,0.0,4.0,7.0,17.0,0.0,2.0,,1.0,0.0,27.0,0.0,,0.0,44.0,0.0,8.0,3.0,0.0,2.0,1.0,,0.0,2.0,0.0,2.0,0.0,2.0,1.0,13.0,0.0,0.0,5.0,6.0,0.0,23.0,2.0,0.0,4.0,1.0,113.0,1.0,1.0,3.0,1.0,0.0,0.0,79.0,0.0,4.0,,,9.0,,1.0,,,0.0,1.0,5.0,0.0,1.0,6.0,3.0,38.0,1.0,0.0,6.0,6.0,44.0,3.0,3.0,5.0,1.0,,7.0,0.0,0.0,31.0,187.0,,126.0,0.0,0.0,0.0,2.0,0.0,2.0,,1.0,2.0,0.0,3.0,1.0,0.0,,1.0,0.0
2024-04-15 00:00:00+00:00,106.0,,127.0,9.0,66.0,406.0,23.0,21.0,82.0,2.0,68.0,0.0,23.0,31.0,0.0,46.0,16.0,9.0,,4.0,0.0,2.0,8.0,18.0,3.0,6.0,8.0,,13.0,1.0,1.0,,,10.0,8.0,0.0,6.0,3.0,0.0,6.0,6.0,20.0,0.0,4.0,,4.0,1.0,27.0,0.0,,1.0,91.0,1.0,9.0,2.0,2.0,6.0,1.0,,1.0,0.0,2.0,1.0,0.0,5.0,4.0,23.0,2.0,2.0,5.0,9.0,0.0,16.0,3.0,1.0,0.0,7.0,61.0,4.0,0.0,22.0,5.0,0.0,0.0,98.0,0.0,1.0,,,12.0,,4.0,,,1.0,1.0,16.0,3.0,5.0,2.0,1.0,57.0,0.0,0.0,19.0,5.0,105.0,1.0,3.0,3.0,0.0,,5.0,3.0,1.0,73.0,193.0,,123.0,3.0,1.0,1.0,0.0,0.0,1.0,,0.0,3.0,10.0,3.0,8.0,0.0,,0.0,0.0
2024-04-16 00:00:00+00:00,104.0,,119.0,21.0,33.0,395.0,31.0,44.0,70.0,5.0,64.0,4.0,10.0,21.0,0.0,47.0,10.0,5.0,,4.0,0.0,1.0,11.0,34.0,1.0,2.0,9.0,,42.0,2.0,4.0,,,12.0,2.0,0.0,16.0,6.0,1.0,22.0,6.0,19.0,2.0,1.0,,7.0,1.0,29.0,3.0,,2.0,138.0,0.0,11.0,5.0,2.0,7.0,1.0,,1.0,1.0,1.0,2.0,0.0,5.0,1.0,22.0,2.0,0.0,11.0,5.0,1.0,23.0,0.0,0.0,16.0,5.0,34.0,1.0,0.0,70.0,6.0,0.0,0.0,114.0,0.0,4.0,,,5.0,,3.0,,,1.0,1.0,4.0,1.0,4.0,1.0,6.0,43.0,1.0,0.0,25.0,10.0,64.0,1.0,3.0,2.0,2.0,,7.0,2.0,1.0,49.0,205.0,,106.0,0.0,0.0,1.0,0.0,0.0,5.0,,0.0,10.0,7.0,3.0,1.0,1.0,,1.0,1.0
2024-04-17 00:00:00+00:00,92.0,,103.0,9.0,38.0,393.0,15.0,36.0,75.0,5.0,76.0,0.0,14.0,14.0,1.0,47.0,6.0,5.0,,0.0,0.0,1.0,9.0,22.0,1.0,3.0,5.0,,9.0,2.0,3.0,,,15.0,4.0,3.0,7.0,11.0,2.0,3.0,8.0,23.0,0.0,2.0,,11.0,0.0,17.0,1.0,,3.0,305.0,0.0,16.0,2.0,1.0,4.0,3.0,,0.0,0.0,6.0,0.0,0.0,2.0,0.0,24.0,2.0,6.0,12.0,5.0,4.0,28.0,0.0,0.0,0.0,7.0,58.0,3.0,1.0,32.0,18.0,0.0,0.0,110.0,0.0,3.0,,,8.0,,1.0,,,3.0,1.0,6.0,1.0,0.0,4.0,2.0,45.0,0.0,1.0,25.0,6.0,73.0,3.0,6.0,2.0,2.0,,8.0,5.0,0.0,60.0,242.0,,106.0,1.0,0.0,4.0,0.0,0.0,0.0,,0.0,8.0,5.0,1.0,1.0,0.0,,2.0,0.0
2024-04-18 00:00:00+00:00,171.0,,80.0,6.0,18.0,402.0,25.0,27.0,63.0,8.0,83.0,2.0,16.0,18.0,1.0,92.0,8.0,5.0,,2.0,0.0,0.0,4.0,24.0,3.0,3.0,9.0,,3.0,2.0,0.0,,,21.0,6.0,3.0,14.0,8.0,0.0,13.0,6.0,21.0,1.0,3.0,,11.0,2.0,22.0,4.0,,0.0,75.0,0.0,11.0,1.0,2.0,5.0,0.0,,0.0,2.0,1.0,1.0,2.0,0.0,3.0,36.0,1.0,3.0,5.0,5.0,0.0,14.0,1.0,0.0,2.0,10.0,38.0,6.0,0.0,5.0,17.0,0.0,0.0,118.0,0.0,2.0,,,7.0,,2.0,,,1.0,1.0,4.0,0.0,2.0,3.0,4.0,49.0,1.0,2.0,24.0,5.0,162.0,2.0,1.0,1.0,2.0,,6.0,34.0,2.0,52.0,215.0,,115.0,1.0,2.0,2.0,0.0,0.0,0.0,,0.0,5.0,16.0,3.0,3.0,1.0,,2.0,0.0
2024-04-19 00:00:00+00:00,255.0,,78.0,14.0,30.0,368.0,23.0,38.0,64.0,4.0,72.0,1.0,20.0,14.0,3.0,70.0,7.0,11.0,,3.0,0.0,1.0,3.0,17.0,2.0,2.0,20.0,,3.0,1.0,2.0,,,14.0,6.0,5.0,7.0,10.0,1.0,6.0,7.0,25.0,5.0,5.0,,4.0,3.0,33.0,2.0,,0.0,152.0,0.0,9.0,6.0,4.0,7.0,0.0,,1.0,1.0,3.0,1.0,1.0,2.0,3.0,31.0,5.0,1.0,10.0,11.0,0.0,21.0,2.0,0.0,18.0,4.0,108.0,4.0,3.0,8.0,7.0,0.0,0.0,113.0,0.0,3.0,,,8.0,,4.0,,,0.0,3.0,2.0,1.0,3.0,3.0,1.0,47.0,1.0,0.0,21.0,16.0,81.0,0.0,4.0,0.0,1.0,,5.0,28.0,1.0,48.0,179.0,,115.0,0.0,0.0,3.0,6.0,0.0,1.0,,0.0,0.0,6.0,2.0,5.0,0.0,,3.0,0.0
2024-04-20 00:00:00+00:00,127.0,,86.0,2.0,9.0,381.0,14.0,25.0,84.0,3.0,46.0,2.0,16.0,10.0,1.0,218.0,8.0,7.0,,1.0,0.0,0.0,1.0,11.0,1.0,0.0,16.0,,2.0,2.0,2.0,,,14.0,4.0,10.0,23.0,8.0,0.0,9.0,8.0,14.0,2.0,3.0,,12.0,1.0,20.0,3.0,,0.0,237.0,0.0,12.0,1.0,1.0,12.0,0.0,,3.0,1.0,0.0,0.0,4.0,2.0,3.0,31.0,2.0,0.0,9.0,7.0,4.0,28.0,0.0,0.0,4.0,6.0,33.0,1.0,0.0,5.0,13.0,0.0,0.0,107.0,0.0,1.0,,,6.0,,1.0,,,2.0,0.0,15.0,0.0,0.0,2.0,4.0,27.0,1.0,1.0,26.0,2.0,61.0,0.0,1.0,1.0,3.0,,2.0,3.0,0.0,31.0,145.0,,103.0,0.0,0.0,2.0,0.0,0.0,0.0,,1.0,8.0,6.0,3.0,2.0,0.0,,1.0,0.0
2024-04-21 00:00:00+00:00,175.0,,73.0,14.0,15.0,345.0,9.0,32.0,55.0,6.0,29.0,1.0,11.0,10.0,0.0,103.0,4.0,1.0,,0.0,0.0,3.0,7.0,10.0,4.0,2.0,7.0,,9.0,3.0,0.0,,,4.0,2.0,4.0,7.0,4.0,0.0,5.0,1.0,19.0,0.0,1.0,,2.0,3.0,18.0,3.0,,0.0,251.0,0.0,12.0,0.0,0.0,2.0,3.0,,0.0,0.0,0.0,0.0,5.0,7.0,1.0,26.0,4.0,3.0,7.0,1.0,1.0,28.0,0.0,0.0,3.0,1.0,35.0,0.0,0.0,4.0,29.0,0.0,0.0,78.0,0.0,3.0,,,3.0,,0.0,,,0.0,2.0,2.0,0.0,0.0,1.0,2.0,38.0,1.0,0.0,22.0,4.0,51.0,2.0,1.0,1.0,2.0,,4.0,5.0,3.0,57.0,139.0,,93.0,2.0,0.0,4.0,2.0,0.0,0.0,,0.0,4.0,0.0,0.0,4.0,0.0,,0.0,0.0
2024-04-22 00:00:00+00:00,199.0,,109.0,21.0,28.0,399.0,17.0,38.0,76.0,3.0,58.0,1.0,11.0,25.0,0.0,118.0,6.0,9.0,,6.0,0.0,2.0,6.0,16.0,7.0,0.0,1.0,,10.0,3.0,1.0,,,6.0,8.0,11.0,17.0,7.0,0.0,2.0,6.0,17.0,2.0,0.0,,1.0,5.0,34.0,0.0,,0.0,181.0,0.0,8.0,6.0,0.0,5.0,1.0,,3.0,3.0,28.0,1.0,2.0,1.0,10.0,26.0,2.0,5.0,10.0,9.0,2.0,29.0,0.0,1.0,2.0,9.0,45.0,3.0,1.0,22.0,19.0,0.0,0.0,100.0,0.0,2.0,,,14.0,,6.0,,,2.0,2.0,3.0,1.0,3.0,8.0,3.0,48.0,2.0,1.0,19.0,13.0,72.0,2.0,4.0,2.0,2.0,,9.0,3.0,0.0,51.0,174.0,,86.0,0.0,0.0,1.0,2.0,0.0,0.0,,0.0,3.0,11.0,6.0,5.0,3.0,,2.0,0.0
2024-04-23 00:00:00+00:00,96.0,,102.0,14.0,13.0,391.0,14.0,32.0,59.0,3.0,50.0,0.0,13.0,28.0,0.0,83.0,10.0,6.0,,5.0,0.0,2.0,2.0,11.0,7.0,8.0,4.0,,9.0,4.0,0.0,,,9.0,10.0,3.0,9.0,13.0,0.0,5.0,4.0,25.0,4.0,1.0,,5.0,0.0,31.0,1.0,,2.0,256.0,0.0,16.0,10.0,1.0,7.0,1.0,,2.0,1.0,10.0,1.0,2.0,2.0,1.0,35.0,6.0,10.0,17.0,6.0,3.0,22.0,0.0,1.0,3.0,54.0,49.0,2.0,2.0,20.0,6.0,0.0,0.0,100.0,0.0,2.0,,,17.0,,0.0,,,2.0,2.0,1.0,2.0,2.0,1.0,4.0,47.0,5.0,1.0,18.0,11.0,70.0,1.0,1.0,1.0,3.0,,5.0,1.0,0.0,41.0,174.0,,117.0,1.0,0.0,1.0,1.0,0.0,8.0,,1.0,8.0,15.0,4.0,3.0,0.0,,3.0,0.0
2024-04-24 00:00:00+00:00,121.0,,107.0,45.0,29.0,416.0,14.0,24.0,76.0,5.0,62.0,0.0,9.0,10.0,1.0,61.0,6.0,9.0,,2.0,1.0,1.0,12.0,14.0,3.0,3.0,10.0,,7.0,0.0,1.0,,,16.0,4.0,0.0,11.0,11.0,0.0,7.0,3.0,9.0,1.0,1.0,,5.0,1.0,26.0,3.0,,1.0,212.0,0.0,13.0,10.0,1.0,9.0,4.0,,1.0,3.0,22.0,1.0,4.0,1.0,3.0,33.0,2.0,9.0,9.0,9.0,0.0,22.0,1.0,0.0,4.0,99.0,70.0,2.0,1.0,5.0,19.0,0.0,0.0,101.0,0.0,3.0,,,16.0,,2.0,,,2.0,3.0,1.0,0.0,0.0,4.0,3.0,48.0,2.0,1.0,21.0,8.0,40.0,2.0,2.0,1.0,3.0,,2.0,1.0,1.0,49.0,166.0,,113.0,0.0,2.0,2.0,2.0,0.0,0.0,,0.0,3.0,16.0,5.0,0.0,0.0,,1.0,0.0
2024-04-25 00:00:00+00:00,112.0,,87.0,19.0,28.0,393.0,14.0,27.0,45.0,7.0,43.0,1.0,5.0,24.0,0.0,74.0,10.0,8.0,,4.0,0.0,0.0,1.0,25.0,5.0,10.0,22.0,,11.0,3.0,0.0,,,19.0,16.0,2.0,5.0,4.0,0.0,7.0,7.0,32.0,1.0,4.0,,4.0,5.0,36.0,2.0,,0.0,216.0,0.0,16.0,11.0,3.0,7.0,4.0,,1.0,2.0,1.0,2.0,3.0,5.0,4.0,24.0,2.0,5.0,4.0,8.0,5.0,18.0,0.0,1.0,1.0,68.0,61.0,4.0,3.0,5.0,26.0,0.0,0.0,79.0,1.0,4.0,,,12.0,,2.0,,,0.0,1.0,1.0,0.0,1.0,5.0,6.0,56.0,1.0,1.0,30.0,9.0,65.0,1.0,1.0,5.0,3.0,,7.0,1.0,2.0,36.0,190.0,,107.0,0.0,0.0,0.0,0.0,0.0,0.0,,0.0,1.0,16.0,4.0,3.0,1.0,,2.0,0.0
2024-04-26 00:00:00+00:00,111.0,,102.0,8.0,14.0,441.0,20.0,31.0,45.0,2.0,39.0,4.0,6.0,18.0,2.0,41.0,6.0,11.0,,3.0,0.0,1.0,13.0,10.0,6.0,7.0,9.0,,4.0,1.0,1.0,,,12.0,8.0,2.0,9.0,7.0,0.0,5.0,6.0,11.0,0.0,2.0,,3.0,9.0,26.0,2.0,,0.0,164.0,0.0,8.0,13.0,5.0,3.0,1.0,,1.0,0.0,5.0,2.0,2.0,2.0,5.0,34.0,6.0,7.0,6.0,11.0,2.0,24.0,1.0,0.0,3.0,59.0,66.0,1.0,0.0,0.0,43.0,0.0,0.0,112.0,0.0,2.0,,,12.0,,2.0,,,2.0,3.0,4.0,0.0,2.0,0.0,7.0,58.0,1.0,2.0,12.0,6.0,90.0,1.0,5.0,0.0,3.0,,7.0,0.0,3.0,44.0,158.0,,102.0,2.0,0.0,1.0,0.0,0.0,0.0,,0.0,1.0,10.0,16.0,3.0,0.0,,0.0,0.0
2024-04-27 00:00:00+00:00,63.0,,69.0,10.0,6.0,304.0,12.0,30.0,29.0,9.0,36.0,0.0,7.0,10.0,0.0,27.0,6.0,8.0,,2.0,0.0,3.0,19.0,7.0,1.0,2.0,16.0,,5.0,2.0,3.0,,,12.0,6.0,3.0,7.0,9.0,0.0,7.0,7.0,15.0,1.0,1.0,,7.0,6.0,25.0,2.0,,0.0,196.0,0.0,6.0,11.0,0.0,8.0,1.0,,0.0,1.0,13.0,0.0,3.0,3.0,3.0,14.0,0.0,3.0,2.0,8.0,0.0,25.0,2.0,0.0,0.0,34.0,48.0,3.0,0.0,1.0,12.0,0.0,0.0,101.0,0.0,0.0,,,10.0,,0.0,,,1.0,0.0,3.0,3.0,1.0,1.0,5.0,30.0,0.0,3.0,14.0,3.0,66.0,0.0,4.0,0.0,2.0,,3.0,7.0,0.0,26.0,159.0,,96.0,1.0,0.0,1.0,0.0,0.0,2.0,,0.0,2.0,0.0,2.0,2.0,1.0,,2.0,0.0
2024-04-28 00:00:00+00:00,95.0,,69.0,5.0,14.0,402.0,11.0,28.0,33.0,9.0,42.0,0.0,5.0,18.0,1.0,29.0,8.0,11.0,,0.0,0.0,3.0,3.0,8.0,1.0,5.0,5.0,,3.0,1.0,3.0,,,17.0,5.0,2.0,10.0,9.0,0.0,4.0,4.0,17.0,0.0,2.0,,3.0,24.0,20.0,1.0,,0.0,193.0,0.0,13.0,0.0,0.0,1.0,2.0,,0.0,0.0,28.0,0.0,5.0,0.0,1.0,28.0,0.0,1.0,0.0,11.0,1.0,24.0,0.0,0.0,5.0,14.0,53.0,1.0,1.0,2.0,2.0,1.0,0.0,121.0,1.0,4.0,,,14.0,,0.0,,,0.0,2.0,0.0,1.0,1.0,1.0,2.0,25.0,1.0,1.0,9.0,4.0,61.0,3.0,2.0,1.0,3.0,,3.0,0.0,0.0,40.0,175.0,,104.0,0.0,0.0,1.0,3.0,0.0,1.0,,0.0,3.0,2.0,1.0,3.0,0.0,,1.0,0.0
2024-04-29 00:00:00+00:00,110.0,,70.0,10.0,13.0,389.0,26.0,38.0,39.0,22.0,35.0,2.0,22.0,51.0,1.0,58.0,8.0,11.0,,1.0,2.0,0.0,8.0,14.0,3.0,3.0,3.0,,9.0,0.0,0.0,,,16.0,5.0,2.0,7.0,11.0,0.0,8.0,8.0,12.0,1.0,0.0,,10.0,12.0,26.0,1.0,,4.0,207.0,0.0,6.0,1.0,0.0,3.0,2.0,,2.0,0.0,4.0,0.0,5.0,0.0,4.0,19.0,2.0,2.0,5.0,11.0,0.0,15.0,0.0,0.0,2.0,49.0,41.0,2.0,2.0,7.0,3.0,0.0,0.0,111.0,0.0,3.0,,,10.0,,2.0,,,0.0,3.0,5.0,1.0,2.0,1.0,10.0,30.0,2.0,0.0,17.0,6.0,78.0,0.0,4.0,2.0,3.0,,5.0,11.0,0.0,43.0,150.0,,119.0,1.0,2.0,0.0,3.0,0.0,1.0,,0.0,4.0,9.0,0.0,3.0,0.0,,0.0,0.0
2024-04-30 00:00:00+00:00,129.0,,85.0,17.0,31.0,426.0,41.0,28.0,32.0,17.0,57.0,1.0,29.0,34.0,1.0,38.0,5.0,22.0,,3.0,0.0,1.0,16.0,19.0,1.0,4.0,6.0,,1.0,2.0,1.0,,,18.0,1.0,2.0,10.0,8.0,0.0,2.0,3.0,26.0,1.0,1.0,,14.0,22.0,19.0,3.0,,2.0,188.0,0.0,9.0,7.0,3.0,2.0,1.0,,4.0,0.0,1.0,0.0,6.0,2.0,0.0,32.0,5.0,1.0,5.0,22.0,2.0,17.0,0.0,0.0,3.0,103.0,45.0,1.0,1.0,4.0,19.0,0.0,0.0,117.0,0.0,3.0,,,19.0,,0.0,,,2.0,2.0,4.0,2.0,2.0,6.0,9.0,49.0,1.0,0.0,15.0,8.0,159.0,2.0,4.0,3.0,1.0,,11.0,3.0,1.0,38.0,190.0,,139.0,0.0,0.0,2.0,0.0,0.0,1.0,,0.0,4.0,13.0,3.0,6.0,0.0,,4.0,0.0
2024-05-01 00:00:00+00:00,115.0,,92.0,33.0,17.0,374.0,15.0,27.0,30.0,10.0,38.0,3.0,21.0,13.0,0.0,41.0,16.0,18.0,,0.0,0.0,4.0,4.0,16.0,1.0,1.0,17.0,,5.0,2.0,2.0,,,9.0,11.0,1.0,17.0,4.0,1.0,17.0,4.0,28.0,3.0,3.0,,14.0,17.0,22.0,6.0,,4.0,122.0,0.0,13.0,5.0,1.0,0.0,2.0,,0.0,1.0,2.0,0.0,1.0,3.0,5.0,30.0,2.0,1.0,5.0,18.0,2.0,15.0,1.0,0.0,4.0,110.0,60.0,4.0,2.0,3.0,15.0,0.0,0.0,104.0,0.0,2.0,,,13.0,,4.0,,,8.0,6.0,1.0,1.0,3.0,7.0,10.0,34.0,0.0,2.0,24.0,22.0,77.0,3.0,5.0,0.0,2.0,,3.0,2.0,1.0,37.0,218.0,,107.0,2.0,0.0,1.0,0.0,0.0,1.0,,0.0,1.0,13.0,2.0,4.0,0.0,,2.0,0.0
2024-05-02 00:00:00+00:00,113.0,,71.0,50.0,11.0,354.0,17.0,23.0,40.0,4.0,38.0,2.0,5.0,6.0,3.0,21.0,22.0,10.0,,3.0,0.0,3.0,5.0,29.0,3.0,0.0,7.0,,39.0,5.0,0.0,,,14.0,4.0,1.0,17.0,10.0,2.0,12.0,3.0,25.0,2.0,3.0,,3.0,11.0,36.0,0.0,,3.0,98.0,0.0,20.0,14.0,18.0,3.0,0.0,,0.0,0.0,1.0,0.0,1.0,0.0,10.0,18.0,1.0,1.0,3.0,10.0,1.0,17.0,1.0,1.0,2.0,48.0,50.0,3.0,1.0,0.0,11.0,0.0,0.0,144.0,0.0,3.0,,,10.0,,0.0,,,1.0,0.0,2.0,1.0,0.0,13.0,3.0,33.0,0.0,2.0,16.0,30.0,52.0,3.0,5.0,2.0,0.0,,4.0,0.0,0.0,42.0,190.0,,112.0,1.0,0.0,0.0,0.0,1.0,1.0,,0.0,4.0,36.0,2.0,1.0,2.0,,1.0,0.0
2024-05-03 00:00:00+00:00,99.0,,53.0,29.0,21.0,397.0,13.0,29.0,40.0,9.0,59.0,0.0,5.0,13.0,0.0,27.0,20.0,2.0,,1.0,0.0,1.0,2.0,22.0,0.0,8.0,2.0,,14.0,5.0,1.0,,,17.0,8.0,0.0,33.0,6.0,0.0,2.0,8.0,24.0,3.0,1.0,,4.0,11.0,29.0,0.0,,2.0,154.0,0.0,13.0,7.0,27.0,10.0,0.0,,1.0,0.0,3.0,0.0,0.0,2.0,3.0,19.0,1.0,4.0,9.0,2.0,8.0,13.0,3.0,0.0,4.0,23.0,42.0,0.0,2.0,1.0,13.0,1.0,0.0,103.0,0.0,4.0,,,19.0,,0.0,,,0.0,2.0,0.0,1.0,3.0,5.0,2.0,54.0,2.0,0.0,28.0,11.0,68.0,4.0,3.0,1.0,0.0,,13.0,1.0,1.0,44.0,174.0,,90.0,2.0,0.0,1.0,0.0,1.0,0.0,,0.0,6.0,11.0,0.0,9.0,0.0,,1.0,0.0
2024-05-04 00:00:00+00:00,52.0,,71.0,6.0,16.0,331.0,80.0,36.0,25.0,2.0,28.0,0.0,10.0,7.0,0.0,30.0,15.0,4.0,,0.0,0.0,2.0,2.0,23.0,2.0,1.0,6.0,,2.0,1.0,0.0,,,18.0,12.0,0.0,17.0,12.0,0.0,8.0,9.0,11.0,0.0,2.0,,12.0,17.0,19.0,1.0,,2.0,157.0,0.0,10.0,1.0,9.0,6.0,0.0,,2.0,2.0,0.0,1.0,0.0,2.0,10.0,12.0,2.0,1.0,4.0,4.0,1.0,12.0,0.0,1.0,3.0,8.0,21.0,0.0,0.0,3.0,8.0,0.0,0.0,92.0,0.0,4.0,,,10.0,,0.0,,,0.0,2.0,2.0,2.0,2.0,2.0,2.0,36.0,0.0,0.0,19.0,7.0,93.0,5.0,2.0,0.0,0.0,,4.0,2.0,1.0,28.0,131.0,,89.0,0.0,0.0,0.0,0.0,0.0,3.0,,0.0,4.0,4.0,0.0,2.0,0.0,,2.0,0.0
2024-05-05 00:00:00+00:00,58.0,,84.0,11.0,12.0,311.0,32.0,24.0,22.0,4.0,37.0,0.0,3.0,11.0,0.0,25.0,5.0,1.0,,0.0,0.0,0.0,2.0,23.0,2.0,10.0,9.0,,7.0,13.0,1.0,,,5.0,5.0,0.0,14.0,8.0,0.0,4.0,9.0,14.0,0.0,2.0,,9.0,10.0,18.0,0.0,,1.0,149.0,1.0,10.0,0.0,13.0,3.0,1.0,,1.0,0.0,0.0,1.0,1.0,2.0,3.0,16.0,2.0,0.0,3.0,1.0,0.0,13.0,0.0,0.0,5.0,6.0,40.0,3.0,1.0,8.0,2.0,0.0,0.0,116.0,0.0,5.0,,,12.0,,3.0,,,0.0,7.0,2.0,2.0,0.0,3.0,1.0,26.0,1.0,1.0,11.0,11.0,96.0,1.0,2.0,2.0,0.0,,2.0,0.0,0.0,38.0,131.0,,114.0,2.0,0.0,1.0,0.0,0.0,3.0,,0.0,1.0,0.0,0.0,2.0,1.0,,1.0,0.0
2024-05-06 00:00:00+00:00,85.0,,105.0,5.0,29.0,377.0,39.0,37.0,35.0,2.0,37.0,0.0,20.0,12.0,0.0,37.0,8.0,3.0,,1.0,0.0,3.0,6.0,8.0,7.0,1.0,8.0,,1.0,2.0,2.0,,,24.0,0.0,3.0,16.0,3.0,0.0,4.0,13.0,22.0,0.0,0.0,,7.0,3.0,17.0,1.0,,3.0,168.0,0.0,15.0,1.0,27.0,5.0,0.0,,3.0,1.0,1.0,4.0,1.0,2.0,9.0,24.0,1.0,3.0,6.0,3.0,2.0,12.0,0.0,0.0,10.0,5.0,34.0,1.0,1.0,3.0,8.0,0.0,0.0,90.0,0.0,1.0,,,11.0,,2.0,,,0.0,2.0,1.0,5.0,4.0,2.0,5.0,45.0,1.0,1.0,27.0,6.0,77.0,3.0,4.0,0.0,2.0,,7.0,2.0,8.0,44.0,167.0,,87.0,2.0,0.0,0.0,0.0,0.0,1.0,,3.0,4.0,13.0,0.0,4.0,0.0,,0.0,0.0
2024-05-07 00:00:00+00:00,72.0,,67.0,12.0,23.0,376.0,64.0,36.0,43.0,3.0,42.0,2.0,6.0,6.0,0.0,35.0,9.0,14.0,,6.0,0.0,1.0,0.0,26.0,1.0,1.0,9.0,,10.0,1.0,1.0,,,7.0,2.0,4.0,16.0,15.0,0.0,4.0,7.0,16.0,1.0,2.0,,4.0,6.0,19.0,1.0,,4.0,239.0,0.0,14.0,1.0,56.0,6.0,0.0,,1.0,1.0,0.0,2.0,5.0,2.0,4.0,31.0,4.0,6.0,3.0,14.0,2.0,17.0,1.0,0.0,2.0,12.0,43.0,2.0,1.0,4.0,6.0,0.0,0.0,141.0,0.0,5.0,,,6.0,,2.0,,,0.0,1.0,1.0,2.0,6.0,5.0,5.0,57.0,0.0,1.0,28.0,10.0,71.0,39.0,2.0,1.0,0.0,,4.0,1.0,3.0,41.0,162.0,,94.0,0.0,2.0,0.0,1.0,0.0,2.0,,2.0,7.0,17.0,0.0,4.0,0.0,,2.0,0.0
2024-05-08 00:00:00+00:00,76.0,,69.0,14.0,23.0,410.0,42.0,43.0,54.0,11.0,57.0,2.0,5.0,8.0,0.0,48.0,10.0,6.0,,4.0,0.0,3.0,5.0,15.0,9.0,4.0,3.0,,11.0,0.0,1.0,,,9.0,5.0,0.0,14.0,7.0,0.0,3.0,7.0,17.0,0.0,1.0,,5.0,7.0,72.0,1.0,,12.0,206.0,0.0,11.0,0.0,102.0,3.0,2.0,,1.0,1.0,0.0,4.0,1.0,2.0,12.0,36.0,1.0,7.0,7.0,6.0,0.0,12.0,0.0,0.0,4.0,6.0,49.0,0.0,2.0,4.0,16.0,0.0,0.0,122.0,0.0,7.0,,,22.0,,0.0,,,1.0,1.0,13.0,2.0,2.0,2.0,7.0,43.0,0.0,1.0,18.0,9.0,65.0,70.0,5.0,1.0,1.0,,5.0,1.0,1.0,58.0,153.0,,127.0,3.0,0.0,3.0,0.0,0.0,0.0,,0.0,2.0,15.0,7.0,5.0,0.0,,2.0,0.0
2024-05-09 00:00:00+00:00,69.0,,70.0,10.0,10.0,409.0,14.0,45.0,32.0,6.0,32.0,1.0,6.0,8.0,1.0,62.0,10.0,5.0,,1.0,1.0,1.0,8.0,28.0,0.0,2.0,11.0,,38.0,2.0,2.0,,,0.0,12.0,0.0,24.0,9.0,1.0,9.0,2.0,17.0,0.0,4.0,,0.0,0.0,83.0,3.0,,14.0,423.0,0.0,14.0,6.0,31.0,2.0,3.0,,2.0,1.0,2.0,2.0,1.0,6.0,9.0,16.0,0.0,8.0,7.0,5.0,1.0,17.0,3.0,0.0,2.0,5.0,38.0,0.0,2.0,0.0,40.0,0.0,0.0,138.0,0.0,4.0,,,11.0,,0.0,,,0.0,7.0,5.0,0.0,3.0,1.0,5.0,63.0,3.0,0.0,18.0,9.0,87.0,45.0,2.0,5.0,5.0,,6.0,1.0,0.0,53.0,170.0,,125.0,0.0,1.0,0.0,0.0,0.0,0.0,,0.0,12.0,8.0,0.0,4.0,2.0,,2.0,0.0
2024-05-10 00:00:00+00:00,104.0,,67.0,6.0,9.0,366.0,18.0,35.0,45.0,13.0,39.0,4.0,3.0,4.0,1.0,53.0,3.0,8.0,,2.0,0.0,12.0,5.0,15.0,0.0,1.0,4.0,,7.0,5.0,3.0,,,2.0,3.0,0.0,6.0,6.0,0.0,8.0,4.0,9.0,1.0,1.0,,2.0,1.0,53.0,4.0,,4.0,318.0,0.0,8.0,0.0,15.0,3.0,6.0,,2.0,2.0,14.0,0.0,2.0,4.0,2.0,22.0,5.0,8.0,4.0,8.0,1.0,11.0,3.0,0.0,1.0,3.0,35.0,1.0,0.0,4.0,8.0,0.0,0.0,127.0,0.0,1.0,,,4.0,,1.0,,,0.0,2.0,2.0,3.0,9.0,3.0,5.0,43.0,1.0,0.0,24.0,10.0,64.0,35.0,5.0,2.0,2.0,,12.0,1.0,9.0,48.0,150.0,,111.0,0.0,1.0,2.0,1.0,0.0,0.0,,0.0,4.0,7.0,4.0,3.0,0.0,,2.0,1.0
2024-05-11 00:00:00+00:00,55.0,,73.0,3.0,14.0,309.0,12.0,19.0,30.0,8.0,34.0,0.0,3.0,6.0,0.0,49.0,1.0,3.0,,0.0,0.0,1.0,4.0,9.0,0.0,1.0,2.0,,4.0,1.0,0.0,,,7.0,3.0,2.0,22.0,10.0,0.0,5.0,2.0,24.0,1.0,1.0,,1.0,1.0,37.0,6.0,,2.0,148.0,0.0,10.0,0.0,14.0,3.0,2.0,,0.0,5.0,5.0,0.0,1.0,4.0,7.0,15.0,0.0,3.0,6.0,3.0,2.0,18.0,1.0,0.0,2.0,6.0,27.0,0.0,1.0,0.0,9.0,0.0,0.0,108.0,0.0,2.0,,,15.0,,0.0,,,0.0,1.0,3.0,1.0,1.0,1.0,4.0,23.0,2.0,0.0,18.0,1.0,89.0,0.0,4.0,1.0,1.0,,4.0,0.0,2.0,30.0,147.0,,89.0,0.0,1.0,0.0,1.0,0.0,0.0,,2.0,3.0,1.0,1.0,2.0,0.0,,1.0,0.0
2024-05-12 00:00:00+00:00,50.0,,45.0,5.0,8.0,323.0,15.0,31.0,41.0,4.0,29.0,0.0,10.0,4.0,2.0,29.0,8.0,1.0,,0.0,0.0,1.0,2.0,2.0,0.0,1.0,5.0,,4.0,1.0,0.0,,,5.0,2.0,0.0,31.0,8.0,0.0,5.0,7.0,11.0,1.0,3.0,,4.0,0.0,21.0,3.0,,1.0,146.0,0.0,9.0,0.0,33.0,3.0,2.0,,4.0,1.0,6.0,1.0,2.0,5.0,6.0,14.0,2.0,5.0,5.0,1.0,0.0,22.0,1.0,0.0,4.0,3.0,35.0,2.0,0.0,1.0,10.0,1.0,0.0,153.0,0.0,0.0,,,5.0,,1.0,,,0.0,1.0,22.0,1.0,1.0,1.0,4.0,37.0,0.0,2.0,10.0,4.0,88.0,1.0,0.0,1.0,1.0,,3.0,0.0,0.0,27.0,121.0,,85.0,0.0,0.0,1.0,1.0,0.0,1.0,,0.0,1.0,1.0,0.0,1.0,0.0,,0.0,0.0
2024-05-13 00:00:00+00:00,86.0,,102.0,15.0,16.0,372.0,17.0,37.0,33.0,8.0,36.0,1.0,11.0,9.0,0.0,32.0,8.0,29.0,,3.0,0.0,1.0,4.0,37.0,0.0,0.0,2.0,,18.0,0.0,4.0,,,5.0,0.0,2.0,7.0,7.0,0.0,12.0,3.0,30.0,1.0,0.0,,4.0,4.0,39.0,1.0,,1.0,123.0,0.0,9.0,0.0,26.0,5.0,4.0,,1.0,1.0,3.0,0.0,1.0,10.0,3.0,31.0,0.0,11.0,0.0,29.0,2.0,17.0,1.0,0.0,1.0,13.0,49.0,2.0,1.0,5.0,10.0,0.0,0.0,112.0,1.0,4.0,,,16.0,,5.0,,,1.0,4.0,3.0,1.0,6.0,2.0,3.0,43.0,2.0,3.0,32.0,7.0,78.0,3.0,4.0,2.0,0.0,,6.0,0.0,3.0,67.0,169.0,,110.0,1.0,1.0,3.0,2.0,0.0,0.0,,1.0,8.0,7.0,1.0,2.0,0.0,,4.0,0.0
2024-05-14 00:00:00+00:00,103.0,,98.0,13.0,6.0,477.0,23.0,36.0,45.0,4.0,44.0,0.0,9.0,10.0,0.0,47.0,10.0,17.0,,2.0,0.0,2.0,7.0,26.0,3.0,1.0,8.0,,9.0,3.0,0.0,,,8.0,10.0,1.0,13.0,9.0,0.0,26.0,4.0,16.0,0.0,0.0,,3.0,4.0,23.0,1.0,,3.0,113.0,0.0,13.0,0.0,5.0,4.0,3.0,,1.0,3.0,2.0,2.0,4.0,4.0,7.0,16.0,4.0,8.0,1.0,17.0,3.0,16.0,0.0,0.0,1.0,8.0,41.0,1.0,1.0,0.0,15.0,1.0,0.0,186.0,0.0,2.0,,,20.0,,5.0,,,0.0,3.0,7.0,2.0,11.0,2.0,5.0,38.0,1.0,2.0,37.0,10.0,73.0,3.0,2.0,3.0,1.0,,11.0,0.0,1.0,100.0,204.0,,117.0,1.0,0.0,0.0,2.0,0.0,0.0,,1.0,2.0,4.0,1.0,5.0,0.0,,1.0,0.0
2024-05-15 00:00:00+00:00,121.0,,82.0,12.0,29.0,496.0,16.0,56.0,39.0,5.0,51.0,1.0,24.0,17.0,3.0,47.0,19.0,12.0,,1.0,0.0,3.0,7.0,8.0,3.0,0.0,2.0,,3.0,3.0,1.0,,,9.0,5.0,1.0,19.0,6.0,0.0,12.0,3.0,21.0,0.0,4.0,,0.0,3.0,25.0,1.0,,7.0,154.0,0.0,8.0,1.0,8.0,11.0,4.0,,3.0,1.0,1.0,2.0,4.0,9.0,2.0,22.0,1.0,5.0,4.0,12.0,10.0,18.0,1.0,1.0,3.0,5.0,44.0,2.0,3.0,2.0,20.0,0.0,0.0,170.0,0.0,1.0,,,16.0,,0.0,,,2.0,6.0,2.0,2.0,7.0,3.0,11.0,80.0,1.0,1.0,36.0,3.0,83.0,1.0,4.0,0.0,1.0,,2.0,0.0,0.0,87.0,194.0,,125.0,4.0,1.0,2.0,5.0,0.0,0.0,,1.0,12.0,3.0,6.0,2.0,0.0,,5.0,0.0
2024-05-16 00:00:00+00:00,209.0,,93.0,17.0,37.0,566.0,35.0,48.0,49.0,27.0,95.0,1.0,12.0,11.0,0.0,36.0,17.0,11.0,,4.0,0.0,8.0,5.0,21.0,8.0,0.0,8.0,,7.0,0.0,2.0,,,7.0,1.0,3.0,21.0,8.0,0.0,8.0,3.0,10.0,2.0,6.0,,0.0,3.0,26.0,8.0,,15.0,163.0,0.0,10.0,0.0,9.0,6.0,6.0,,1.0,0.0,1.0,0.0,1.0,8.0,4.0,17.0,1.0,0.0,7.0,11.0,2.0,19.0,1.0,1.0,6.0,11.0,29.0,2.0,1.0,1.0,12.0,0.0,0.0,205.0,0.0,3.0,,,11.0,,0.0,,,1.0,7.0,0.0,1.0,6.0,1.0,1.0,65.0,2.0,1.0,30.0,8.0,79.0,0.0,1.0,1.0,0.0,,1.0,2.0,1.0,59.0,214.0,,143.0,2.0,1.0,2.0,2.0,3.0,0.0,,1.0,5.0,7.0,2.0,2.0,0.0,,3.0,0.0
2024-05-17 00:00:00+00:00,239.0,,55.0,15.0,66.0,632.0,39.0,97.0,18.0,13.0,70.0,1.0,9.0,11.0,0.0,28.0,19.0,4.0,,5.0,0.0,2.0,8.0,7.0,0.0,1.0,6.0,,8.0,0.0,1.0,,,10.0,0.0,2.0,18.0,11.0,0.0,16.0,3.0,13.0,1.0,2.0,,13.0,4.0,21.0,3.0,,17.0,122.0,0.0,15.0,1.0,2.0,5.0,1.0,,3.0,1.0,3.0,0.0,5.0,6.0,7.0,16.0,2.0,3.0,7.0,4.0,0.0,16.0,0.0,0.0,3.0,3.0,40.0,3.0,8.0,3.0,2.0,0.0,0.0,120.0,0.0,4.0,,,11.0,,1.0,,,0.0,3.0,3.0,4.0,6.0,2.0,10.0,88.0,1.0,0.0,19.0,10.0,52.0,0.0,0.0,1.0,4.0,,1.0,1.0,1.0,64.0,166.0,,115.0,1.0,0.0,1.0,0.0,1.0,0.0,,0.0,10.0,2.0,1.0,2.0,0.0,,1.0,1.0
2024-05-18 00:00:00+00:00,93.0,,92.0,6.0,50.0,437.0,18.0,29.0,17.0,3.0,82.0,1.0,7.0,17.0,0.0,19.0,11.0,9.0,,0.0,0.0,0.0,5.0,15.0,0.0,1.0,9.0,,6.0,0.0,1.0,,,5.0,3.0,1.0,10.0,10.0,0.0,10.0,3.0,16.0,0.0,0.0,,4.0,5.0,12.0,1.0,,2.0,85.0,0.0,5.0,0.0,3.0,3.0,0.0,,0.0,1.0,3.0,1.0,5.0,4.0,2.0,11.0,2.0,2.0,4.0,8.0,2.0,14.0,0.0,0.0,2.0,5.0,37.0,0.0,3.0,4.0,4.0,1.0,0.0,214.0,0.0,4.0,,,10.0,,1.0,,,0.0,4.0,4.0,2.0,2.0,3.0,3.0,37.0,1.0,0.0,15.0,5.0,48.0,2.0,1.0,2.0,2.0,,2.0,0.0,0.0,47.0,139.0,,105.0,1.0,1.0,1.0,0.0,0.0,0.0,,0.0,0.0,1.0,1.0,3.0,0.0,,0.0,1.0
2024-05-19 00:00:00+00:00,105.0,,78.0,12.0,20.0,421.0,13.0,27.0,9.0,5.0,74.0,1.0,14.0,7.0,0.0,11.0,11.0,15.0,,2.0,0.0,2.0,14.0,4.0,0.0,2.0,4.0,,2.0,2.0,2.0,,,27.0,1.0,2.0,7.0,8.0,1.0,11.0,0.0,11.0,0.0,1.0,,3.0,1.0,9.0,1.0,,1.0,93.0,0.0,10.0,0.0,11.0,11.0,1.0,,1.0,0.0,5.0,1.0,3.0,4.0,3.0,13.0,3.0,4.0,6.0,15.0,0.0,13.0,0.0,1.0,3.0,2.0,41.0,3.0,3.0,5.0,3.0,0.0,0.0,101.0,0.0,3.0,,,14.0,,2.0,,,1.0,4.0,0.0,0.0,3.0,0.0,1.0,29.0,1.0,1.0,16.0,7.0,56.0,1.0,0.0,0.0,4.0,,5.0,0.0,1.0,32.0,139.0,,82.0,0.0,0.0,1.0,0.0,1.0,0.0,,0.0,2.0,2.0,0.0,6.0,0.0,,1.0,0.0
2024-05-20 00:00:00+00:00,125.0,,77.0,10.0,23.0,474.0,18.0,28.0,62.0,5.0,65.0,2.0,55.0,44.0,0.0,46.0,11.0,10.0,,7.0,0.0,1.0,7.0,15.0,2.0,1.0,5.0,,9.0,0.0,2.0,,,6.0,4.0,1.0,10.0,3.0,0.0,17.0,4.0,16.0,1.0,6.0,,1.0,7.0,20.0,3.0,,2.0,125.0,0.0,12.0,0.0,9.0,7.0,1.0,,3.0,2.0,1.0,0.0,2.0,8.0,3.0,19.0,3.0,9.0,2.0,10.0,1.0,14.0,0.0,0.0,3.0,5.0,35.0,1.0,2.0,3.0,9.0,1.0,0.0,164.0,0.0,5.0,,,8.0,,0.0,,,2.0,6.0,2.0,4.0,2.0,2.0,2.0,79.0,1.0,0.0,20.0,5.0,42.0,0.0,3.0,2.0,2.0,,2.0,0.0,1.0,46.0,164.0,,106.0,1.0,3.0,1.0,0.0,0.0,0.0,,0.0,4.0,5.0,1.0,5.0,2.0,,1.0,1.0
2024-05-21 00:00:00+00:00,117.0,,157.0,14.0,26.0,613.0,20.0,32.0,49.0,44.0,61.0,2.0,32.0,18.0,1.0,22.0,11.0,8.0,,5.0,0.0,0.0,6.0,14.0,1.0,1.0,3.0,,7.0,2.0,1.0,,,7.0,4.0,2.0,20.0,5.0,0.0,17.0,3.0,12.0,0.0,7.0,,7.0,0.0,21.0,3.0,,5.0,181.0,0.0,15.0,2.0,0.0,7.0,0.0,,2.0,0.0,5.0,3.0,2.0,4.0,5.0,17.0,0.0,1.0,6.0,8.0,2.0,15.0,0.0,0.0,1.0,6.0,28.0,2.0,2.0,11.0,10.0,2.0,0.0,121.0,0.0,4.0,,,12.0,,3.0,,,3.0,4.0,3.0,1.0,4.0,1.0,4.0,62.0,5.0,1.0,14.0,7.0,70.0,5.0,3.0,1.0,1.0,,8.0,2.0,2.0,82.0,172.0,,114.0,1.0,0.0,1.0,1.0,0.0,0.0,,0.0,5.0,6.0,2.0,2.0,5.0,,0.0,1.0
2024-05-22 00:00:00+00:00,99.0,,116.0,16.0,26.0,620.0,12.0,24.0,30.0,19.0,55.0,2.0,18.0,17.0,2.0,38.0,6.0,22.0,,3.0,0.0,0.0,6.0,9.0,2.0,4.0,9.0,,2.0,4.0,1.0,,,4.0,3.0,4.0,8.0,7.0,0.0,10.0,3.0,16.0,1.0,2.0,,3.0,3.0,18.0,5.0,,6.0,145.0,0.0,8.0,1.0,4.0,3.0,2.0,,0.0,0.0,12.0,5.0,4.0,8.0,2.0,22.0,0.0,3.0,1.0,22.0,3.0,16.0,4.0,1.0,2.0,3.0,51.0,4.0,2.0,10.0,4.0,0.0,0.0,152.0,0.0,5.0,,,20.0,,1.0,,,1.0,6.0,2.0,1.0,3.0,2.0,4.0,51.0,2.0,0.0,32.0,10.0,59.0,3.0,2.0,1.0,1.0,,6.0,0.0,1.0,53.0,176.0,,121.0,3.0,0.0,1.0,0.0,0.0,0.0,,1.0,1.0,10.0,0.0,3.0,1.0,,1.0,0.0
2024-05-23 00:00:00+00:00,113.0,,93.0,7.0,41.0,574.0,17.0,32.0,30.0,9.0,73.0,1.0,15.0,16.0,0.0,31.0,11.0,14.0,,2.0,0.0,4.0,8.0,7.0,0.0,3.0,10.0,,7.0,6.0,1.0,,,2.0,2.0,2.0,15.0,7.0,0.0,11.0,3.0,6.0,0.0,1.0,,4.0,2.0,29.0,4.0,,15.0,102.0,0.0,20.0,2.0,3.0,3.0,1.0,,1.0,2.0,2.0,3.0,3.0,9.0,3.0,17.0,2.0,1.0,4.0,14.0,0.0,6.0,2.0,1.0,2.0,11.0,52.0,7.0,2.0,8.0,10.0,0.0,0.0,120.0,0.0,5.0,,,17.0,,1.0,,,1.0,7.0,2.0,1.0,4.0,3.0,4.0,62.0,2.0,2.0,29.0,11.0,45.0,7.0,2.0,1.0,5.0,,3.0,0.0,1.0,40.0,180.0,,133.0,1.0,0.0,0.0,0.0,0.0,0.0,,0.0,5.0,4.0,0.0,1.0,1.0,,2.0,0.0
2024-05-24 00:00:00+00:00,165.0,,97.0,10.0,96.0,494.0,21.0,27.0,47.0,27.0,75.0,0.0,13.0,18.0,1.0,22.0,11.0,10.0,,1.0,0.0,4.0,4.0,6.0,0.0,2.0,9.0,,6.0,5.0,2.0,,,4.0,5.0,2.0,7.0,6.0,0.0,6.0,4.0,19.0,2.0,7.0,,1.0,1.0,26.0,1.0,,1.0,118.0,0.0,16.0,1.0,3.0,1.0,1.0,,1.0,1.0,2.0,5.0,2.0,2.0,4.0,24.0,3.0,0.0,2.0,10.0,2.0,15.0,2.0,0.0,0.0,14.0,44.0,2.0,0.0,4.0,7.0,1.0,0.0,109.0,0.0,2.0,,,18.0,,1.0,,,0.0,3.0,1.0,4.0,5.0,3.0,2.0,51.0,4.0,1.0,17.0,21.0,44.0,4.0,1.0,2.0,0.0,,8.0,0.0,0.0,57.0,181.0,,125.0,2.0,0.0,2.0,2.0,0.0,0.0,,0.0,3.0,8.0,0.0,4.0,1.0,,1.0,0.0
2024-05-25 00:00:00+00:00,91.0,,115.0,6.0,88.0,351.0,17.0,21.0,24.0,22.0,67.0,1.0,8.0,15.0,2.0,14.0,7.0,8.0,,0.0,0.0,0.0,1.0,6.0,0.0,0.0,9.0,,4.0,2.0,2.0,,,8.0,3.0,0.0,11.0,5.0,2.0,14.0,2.0,15.0,0.0,4.0,,19.0,1.0,12.0,0.0,,1.0,92.0,0.0,6.0,1.0,6.0,4.0,3.0,,1.0,2.0,3.0,0.0,4.0,1.0,2.0,26.0,1.0,5.0,3.0,8.0,0.0,12.0,0.0,0.0,3.0,6.0,30.0,0.0,3.0,4.0,3.0,0.0,0.0,124.0,0.0,4.0,,,8.0,,0.0,,,0.0,2.0,4.0,2.0,3.0,0.0,12.0,37.0,1.0,1.0,15.0,16.0,50.0,2.0,3.0,0.0,3.0,,9.0,0.0,0.0,43.0,132.0,,94.0,0.0,1.0,1.0,0.0,0.0,0.0,,0.0,1.0,9.0,0.0,3.0,0.0,,2.0,0.0
2024-05-26 00:00:00+00:00,75.0,,98.0,16.0,73.0,375.0,12.0,27.0,19.0,19.0,37.0,0.0,5.0,8.0,0.0,15.0,4.0,4.0,,0.0,0.0,6.0,4.0,3.0,0.0,2.0,5.0,,2.0,0.0,2.0,,,2.0,2.0,1.0,4.0,5.0,0.0,11.0,2.0,17.0,0.0,1.0,,9.0,1.0,13.0,0.0,,2.0,71.0,0.0,12.0,0.0,3.0,8.0,0.0,,0.0,0.0,1.0,3.0,1.0,2.0,1.0,17.0,0.0,0.0,7.0,4.0,0.0,13.0,0.0,1.0,1.0,7.0,30.0,2.0,3.0,7.0,8.0,0.0,0.0,73.0,1.0,2.0,,,16.0,,3.0,,,0.0,1.0,0.0,0.0,1.0,3.0,5.0,46.0,0.0,1.0,17.0,5.0,48.0,2.0,0.0,2.0,1.0,,1.0,0.0,1.0,28.0,109.0,,87.0,1.0,0.0,0.0,0.0,0.0,6.0,,0.0,1.0,6.0,0.0,3.0,1.0,,0.0,0.0
2024-05-27 00:00:00+00:00,173.0,,126.0,16.0,44.0,389.0,24.0,25.0,34.0,11.0,57.0,2.0,15.0,14.0,1.0,24.0,3.0,10.0,,3.0,0.0,5.0,11.0,8.0,3.0,3.0,6.0,,5.0,7.0,3.0,,,2.0,1.0,2.0,11.0,2.0,0.0,12.0,4.0,14.0,0.0,1.0,,11.0,1.0,18.0,2.0,,6.0,193.0,0.0,23.0,2.0,17.0,1.0,0.0,,0.0,0.0,2.0,1.0,2.0,2.0,3.0,26.0,3.0,0.0,4.0,10.0,0.0,14.0,1.0,0.0,2.0,10.0,27.0,0.0,4.0,9.0,9.0,0.0,0.0,80.0,0.0,6.0,,,13.0,,3.0,,,0.0,6.0,3.0,2.0,3.0,6.0,2.0,42.0,0.0,2.0,21.0,21.0,57.0,5.0,2.0,1.0,4.0,,4.0,0.0,4.0,37.0,168.0,,105.0,0.0,1.0,0.0,0.0,0.0,1.0,,0.0,2.0,2.0,0.0,2.0,1.0,,0.0,0.0
2024-05-28 00:00:00+00:00,160.0,,83.0,16.0,27.0,410.0,15.0,28.0,22.0,12.0,63.0,2.0,10.0,12.0,2.0,19.0,2.0,15.0,,5.0,0.0,4.0,4.0,15.0,2.0,5.0,4.0,,0.0,2.0,2.0,,,2.0,4.0,12.0,10.0,18.0,1.0,9.0,3.0,18.0,0.0,2.0,,6.0,1.0,10.0,0.0,,4.0,115.0,0.0,8.0,1.0,1.0,2.0,2.0,,0.0,0.0,2.0,2.0,0.0,2.0,1.0,20.0,2.0,0.0,4.0,15.0,5.0,27.0,3.0,0.0,2.0,6.0,54.0,4.0,0.0,7.0,2.0,0.0,0.0,95.0,0.0,1.0,,,11.0,,1.0,,,0.0,0.0,0.0,1.0,4.0,2.0,5.0,46.0,1.0,0.0,20.0,1.0,64.0,2.0,3.0,1.0,1.0,,1.0,2.0,2.0,38.0,179.0,,98.0,0.0,0.0,0.0,0.0,0.0,0.0,,0.0,1.0,10.0,1.0,4.0,1.0,,3.0,0.0
2024-05-29 00:00:00+00:00,144.0,,75.0,15.0,25.0,474.0,11.0,25.0,56.0,2.0,56.0,0.0,7.0,8.0,0.0,28.0,5.0,10.0,,1.0,0.0,3.0,5.0,16.0,2.0,0.0,4.0,,1.0,2.0,12.0,,,2.0,4.0,2.0,10.0,7.0,0.0,16.0,6.0,14.0,1.0,4.0,,5.0,1.0,23.0,1.0,,9.0,75.0,0.0,13.0,1.0,5.0,3.0,1.0,,0.0,0.0,2.0,2.0,3.0,2.0,5.0,12.0,0.0,2.0,5.0,10.0,1.0,15.0,1.0,0.0,2.0,11.0,45.0,2.0,2.0,9.0,5.0,0.0,0.0,58.0,0.0,4.0,,,13.0,,1.0,,,3.0,1.0,6.0,3.0,2.0,1.0,3.0,43.0,0.0,0.0,23.0,4.0,56.0,0.0,3.0,0.0,2.0,,8.0,0.0,1.0,43.0,279.0,,100.0,0.0,0.0,0.0,0.0,1.0,0.0,,1.0,4.0,10.0,1.0,4.0,0.0,,1.0,0.0
2024-05-30 00:00:00+00:00,157.0,,51.0,21.0,21.0,480.0,6.0,39.0,20.0,3.0,35.0,0.0,10.0,5.0,0.0,27.0,3.0,4.0,,1.0,0.0,3.0,6.0,8.0,1.0,1.0,4.0,,2.0,61.0,1.0,,,3.0,1.0,4.0,11.0,9.0,0.0,9.0,6.0,16.0,0.0,2.0,,4.0,0.0,28.0,1.0,,2.0,73.0,0.0,8.0,2.0,2.0,5.0,0.0,,0.0,1.0,0.0,1.0,7.0,1.0,4.0,20.0,3.0,1.0,5.0,4.0,2.0,19.0,0.0,0.0,2.0,6.0,40.0,8.0,0.0,2.0,1.0,0.0,0.0,52.0,0.0,2.0,,,11.0,,1.0,,,2.0,1.0,1.0,2.0,3.0,3.0,3.0,45.0,2.0,1.0,24.0,8.0,44.0,1.0,2.0,1.0,1.0,,1.0,0.0,0.0,43.0,176.0,,109.0,0.0,0.0,0.0,0.0,0.0,0.0,,5.0,0.0,8.0,0.0,3.0,1.0,,2.0,1.0
2024-05-31 00:00:00+00:00,143.0,,71.0,11.0,26.0,434.0,4.0,30.0,20.0,8.0,44.0,0.0,8.0,4.0,0.0,34.0,2.0,6.0,,1.0,0.0,3.0,5.0,21.0,1.0,0.0,7.0,,10.0,10.0,0.0,,,1.0,6.0,2.0,8.0,2.0,0.0,3.0,2.0,7.0,0.0,1.0,,1.0,4.0,23.0,5.0,,2.0,73.0,0.0,5.0,2.0,2.0,1.0,3.0,,0.0,0.0,1.0,3.0,3.0,1.0,6.0,13.0,0.0,1.0,4.0,6.0,3.0,15.0,0.0,0.0,2.0,0.0,58.0,0.0,0.0,3.0,11.0,0.0,0.0,111.0,0.0,1.0,,,8.0,,0.0,,,2.0,4.0,7.0,1.0,3.0,1.0,3.0,32.0,2.0,0.0,28.0,6.0,46.0,2.0,1.0,3.0,1.0,,5.0,0.0,0.0,43.0,179.0,,106.0,3.0,0.0,0.0,0.0,1.0,0.0,,0.0,3.0,11.0,0.0,5.0,0.0,,0.0,1.0
2024-06-01 00:00:00+00:00,84.0,,79.0,5.0,41.0,313.0,11.0,17.0,19.0,3.0,33.0,0.0,7.0,9.0,1.0,31.0,3.0,1.0,,3.0,0.0,1.0,5.0,11.0,0.0,2.0,7.0,,0.0,2.0,0.0,,,5.0,3.0,1.0,3.0,5.0,0.0,5.0,4.0,10.0,1.0,1.0,,2.0,0.0,12.0,0.0,,2.0,34.0,0.0,32.0,1.0,1.0,3.0,1.0,,0.0,0.0,0.0,0.0,1.0,0.0,3.0,10.0,1.0,0.0,3.0,1.0,1.0,13.0,0.0,0.0,0.0,1.0,33.0,1.0,0.0,4.0,1.0,0.0,0.0,62.0,0.0,6.0,,,11.0,,1.0,,,0.0,0.0,2.0,0.0,0.0,1.0,3.0,30.0,0.0,0.0,10.0,3.0,50.0,1.0,1.0,0.0,1.0,,6.0,0.0,0.0,28.0,141.0,,73.0,1.0,0.0,2.0,0.0,0.0,1.0,,0.0,2.0,4.0,0.0,2.0,1.0,,1.0,0.0
2024-06-02 00:00:00+00:00,65.0,,84.0,11.0,39.0,281.0,2.0,19.0,23.0,1.0,36.0,0.0,11.0,11.0,1.0,37.0,8.0,3.0,,1.0,0.0,0.0,0.0,4.0,1.0,2.0,3.0,,2.0,0.0,0.0,,,2.0,1.0,1.0,4.0,3.0,0.0,4.0,2.0,15.0,0.0,0.0,,36.0,2.0,23.0,5.0,,3.0,61.0,0.0,12.0,0.0,4.0,1.0,2.0,,0.0,0.0,0.0,1.0,2.0,3.0,6.0,8.0,2.0,4.0,1.0,3.0,5.0,14.0,1.0,1.0,2.0,6.0,24.0,2.0,0.0,1.0,2.0,0.0,0.0,43.0,0.0,5.0,,,5.0,,1.0,,,1.0,2.0,1.0,0.0,1.0,3.0,4.0,34.0,2.0,0.0,17.0,3.0,48.0,1.0,2.0,1.0,3.0,,2.0,0.0,1.0,38.0,146.0,,69.0,0.0,0.0,0.0,2.0,0.0,0.0,,0.0,0.0,2.0,1.0,3.0,0.0,,2.0,0.0
2024-06-03 00:00:00+00:00,133.0,,75.0,5.0,45.0,411.0,9.0,35.0,35.0,5.0,60.0,1.0,11.0,14.0,0.0,34.0,9.0,5.0,,2.0,0.0,4.0,13.0,13.0,1.0,1.0,0.0,,4.0,1.0,3.0,,,5.0,7.0,1.0,7.0,10.0,1.0,9.0,3.0,20.0,0.0,5.0,,8.0,5.0,19.0,5.0,,5.0,57.0,0.0,28.0,4.0,0.0,2.0,3.0,,0.0,0.0,2.0,0.0,1.0,1.0,2.0,26.0,1.0,2.0,3.0,5.0,2.0,13.0,1.0,0.0,4.0,4.0,61.0,1.0,2.0,5.0,0.0,21.0,0.0,44.0,0.0,2.0,,,11.0,,3.0,,,0.0,6.0,0.0,0.0,10.0,0.0,10.0,35.0,1.0,0.0,40.0,13.0,87.0,2.0,0.0,1.0,1.0,,2.0,0.0,0.0,84.0,159.0,,111.0,1.0,0.0,0.0,0.0,0.0,0.0,,0.0,3.0,5.0,1.0,6.0,0.0,,5.0,0.0
2024-06-04 00:00:00+00:00,104.0,,88.0,10.0,35.0,478.0,24.0,29.0,43.0,5.0,51.0,2.0,4.0,6.0,1.0,49.0,9.0,11.0,,3.0,0.0,2.0,5.0,26.0,1.0,2.0,10.0,,8.0,1.0,1.0,,,3.0,2.0,1.0,45.0,13.0,1.0,15.0,3.0,15.0,0.0,2.0,,3.0,8.0,19.0,0.0,,4.0,75.0,0.0,10.0,0.0,2.0,4.0,2.0,,0.0,1.0,0.0,1.0,2.0,4.0,4.0,17.0,0.0,11.0,2.0,11.0,1.0,17.0,0.0,0.0,1.0,11.0,70.0,2.0,3.0,4.0,10.0,1.0,0.0,48.0,0.0,4.0,,,14.0,,1.0,,,0.0,0.0,4.0,1.0,2.0,8.0,4.0,39.0,1.0,2.0,24.0,10.0,51.0,2.0,3.0,1.0,4.0,,2.0,0.0,3.0,67.0,181.0,,109.0,1.0,0.0,1.0,0.0,0.0,0.0,,0.0,2.0,7.0,0.0,2.0,0.0,,3.0,0.0
2024-06-05 00:00:00+00:00,92.0,,107.0,14.0,28.0,489.0,6.0,28.0,45.0,1.0,69.0,8.0,12.0,6.0,0.0,52.0,9.0,6.0,,1.0,0.0,2.0,5.0,6.0,0.0,0.0,6.0,,4.0,3.0,0.0,,,11.0,1.0,6.0,8.0,10.0,0.0,36.0,1.0,11.0,0.0,2.0,,18.0,0.0,25.0,5.0,,4.0,70.0,0.0,16.0,0.0,11.0,1.0,0.0,,0.0,2.0,1.0,1.0,5.0,4.0,6.0,15.0,2.0,2.0,10.0,6.0,3.0,20.0,0.0,0.0,5.0,6.0,70.0,0.0,1.0,4.0,12.0,3.0,0.0,38.0,0.0,2.0,,,14.0,,1.0,,,2.0,2.0,2.0,2.0,4.0,2.0,14.0,50.0,2.0,0.0,27.0,9.0,48.0,1.0,5.0,6.0,2.0,,0.0,1.0,1.0,94.0,160.0,,113.0,1.0,0.0,0.0,0.0,0.0,1.0,,2.0,4.0,6.0,0.0,4.0,0.0,,2.0,0.0
2024-06-06 00:00:00+00:00,110.0,,84.0,21.0,26.0,503.0,7.0,36.0,44.0,2.0,48.0,3.0,6.0,11.0,3.0,17.0,4.0,13.0,,4.0,0.0,5.0,3.0,15.0,0.0,3.0,4.0,,6.0,0.0,3.0,,,8.0,2.0,1.0,14.0,4.0,0.0,15.0,7.0,14.0,0.0,6.0,,7.0,1.0,13.0,2.0,,10.0,63.0,0.0,12.0,0.0,3.0,3.0,7.0,,0.0,4.0,0.0,0.0,3.0,3.0,5.0,10.0,1.0,1.0,5.0,13.0,2.0,14.0,2.0,0.0,10.0,6.0,72.0,4.0,1.0,23.0,8.0,4.0,0.0,51.0,0.0,4.0,,,15.0,,0.0,,,0.0,2.0,5.0,1.0,8.0,2.0,5.0,43.0,0.0,1.0,31.0,17.0,74.0,1.0,0.0,3.0,2.0,,4.0,0.0,1.0,91.0,219.0,,112.0,3.0,0.0,0.0,0.0,0.0,0.0,,1.0,6.0,9.0,0.0,6.0,0.0,,2.0,0.0
2024-06-07 00:00:00+00:00,79.0,,65.0,9.0,36.0,483.0,6.0,40.0,67.0,4.0,79.0,5.0,13.0,9.0,0.0,25.0,1.0,5.0,,2.0,0.0,10.0,1.0,5.0,3.0,0.0,4.0,,6.0,1.0,4.0,,,5.0,3.0,6.0,6.0,6.0,0.0,12.0,7.0,26.0,0.0,9.0,,19.0,5.0,27.0,0.0,,9.0,51.0,0.0,13.0,2.0,6.0,4.0,2.0,,0.0,0.0,0.0,0.0,2.0,0.0,4.0,9.0,1.0,2.0,7.0,5.0,1.0,19.0,1.0,0.0,5.0,0.0,62.0,2.0,0.0,48.0,7.0,1.0,0.0,64.0,0.0,4.0,,,10.0,,2.0,,,0.0,3.0,0.0,2.0,13.0,2.0,4.0,43.0,4.0,0.0,47.0,18.0,61.0,2.0,2.0,0.0,0.0,,2.0,1.0,0.0,119.0,189.0,,125.0,1.0,0.0,2.0,0.0,0.0,0.0,,1.0,5.0,14.0,3.0,8.0,1.0,,1.0,0.0
2024-06-08 00:00:00+00:00,85.0,,51.0,9.0,21.0,367.0,3.0,29.0,48.0,5.0,51.0,2.0,6.0,2.0,0.0,14.0,3.0,3.0,,0.0,0.0,7.0,3.0,0.0,0.0,1.0,3.0,,2.0,1.0,1.0,,,0.0,6.0,2.0,10.0,7.0,0.0,14.0,3.0,23.0,0.0,5.0,,9.0,1.0,14.0,4.0,,3.0,57.0,0.0,12.0,0.0,2.0,0.0,1.0,,0.0,0.0,0.0,2.0,3.0,2.0,3.0,6.0,2.0,0.0,2.0,3.0,1.0,26.0,0.0,1.0,0.0,7.0,53.0,0.0,3.0,71.0,17.0,0.0,0.0,32.0,0.0,1.0,,,8.0,,0.0,,,0.0,5.0,1.0,3.0,2.0,0.0,0.0,41.0,1.0,0.0,15.0,15.0,45.0,2.0,3.0,5.0,1.0,,8.0,0.0,2.0,56.0,157.0,,118.0,1.0,1.0,0.0,1.0,0.0,0.0,,0.0,6.0,2.0,0.0,2.0,1.0,,1.0,0.0
2024-06-09 00:00:00+00:00,61.0,,87.0,15.0,9.0,316.0,11.0,23.0,33.0,1.0,44.0,0.0,6.0,5.0,0.0,12.0,3.0,2.0,,0.0,0.0,16.0,6.0,14.0,3.0,0.0,2.0,,0.0,1.0,2.0,,,2.0,2.0,0.0,13.0,3.0,0.0,26.0,0.0,8.0,0.0,1.0,,2.0,0.0,18.0,5.0,,0.0,50.0,0.0,10.0,0.0,1.0,3.0,0.0,,1.0,1.0,1.0,0.0,1.0,2.0,1.0,13.0,0.0,4.0,2.0,2.0,0.0,16.0,0.0,0.0,2.0,0.0,34.0,0.0,0.0,31.0,41.0,0.0,0.0,31.0,0.0,1.0,,,10.0,,1.0,,,0.0,1.0,1.0,0.0,3.0,0.0,1.0,33.0,1.0,1.0,10.0,3.0,44.0,3.0,0.0,1.0,0.0,,3.0,0.0,1.0,45.0,120.0,,108.0,0.0,0.0,0.0,0.0,0.0,0.0,,0.0,2.0,0.0,7.0,1.0,0.0,,1.0,0.0
2024-06-10 00:00:00+00:00,107.0,,99.0,15.0,31.0,382.0,12.0,31.0,50.0,7.0,42.0,1.0,9.0,8.0,0.0,19.0,4.0,7.0,,4.0,0.0,2.0,1.0,13.0,2.0,1.0,5.0,,4.0,0.0,1.0,,,9.0,7.0,3.0,12.0,3.0,0.0,39.0,3.0,33.0,0.0,6.0,,13.0,0.0,16.0,1.0,,4.0,49.0,0.0,16.0,1.0,4.0,2.0,3.0,,0.0,2.0,1.0,0.0,3.0,2.0,4.0,17.0,0.0,3.0,1.0,7.0,1.0,13.0,1.0,3.0,2.0,1.0,48.0,2.0,0.0,41.0,6.0,0.0,0.0,49.0,0.0,7.0,,,6.0,,1.0,,,4.0,1.0,0.0,1.0,3.0,5.0,1.0,41.0,2.0,0.0,26.0,8.0,45.0,8.0,2.0,2.0,2.0,,6.0,0.0,0.0,70.0,140.0,,89.0,0.0,1.0,2.0,0.0,0.0,0.0,,0.0,3.0,1.0,2.0,2.0,0.0,,0.0,1.0
2024-06-11 00:00:00+00:00,101.0,,81.0,15.0,27.0,381.0,8.0,34.0,45.0,2.0,81.0,1.0,3.0,7.0,0.0,26.0,7.0,7.0,,4.0,1.0,5.0,3.0,17.0,1.0,0.0,1.0,,5.0,1.0,0.0,,,11.0,2.0,2.0,18.0,5.0,0.0,10.0,4.0,16.0,0.0,3.0,,8.0,2.0,27.0,1.0,,3.0,63.0,0.0,13.0,1.0,1.0,2.0,1.0,,1.0,0.0,1.0,4.0,0.0,3.0,8.0,12.0,1.0,0.0,4.0,7.0,1.0,26.0,0.0,0.0,4.0,4.0,53.0,2.0,0.0,35.0,5.0,0.0,0.0,66.0,0.0,2.0,,,10.0,,2.0,,,1.0,4.0,1.0,0.0,5.0,1.0,4.0,34.0,1.0,2.0,53.0,14.0,77.0,2.0,2.0,3.0,0.0,,11.0,0.0,1.0,80.0,164.0,,115.0,0.0,1.0,0.0,0.0,0.0,2.0,,1.0,7.0,5.0,0.0,3.0,0.0,,1.0,0.0
2024-06-12 00:00:00+00:00,81.0,,60.0,12.0,24.0,414.0,24.0,25.0,68.0,4.0,60.0,1.0,7.0,7.0,0.0,19.0,6.0,7.0,,1.0,0.0,1.0,2.0,23.0,6.0,2.0,3.0,,2.0,0.0,1.0,,,5.0,22.0,1.0,8.0,13.0,0.0,7.0,2.0,13.0,0.0,3.0,,6.0,1.0,24.0,1.0,,0.0,71.0,0.0,17.0,1.0,3.0,2.0,3.0,,1.0,0.0,3.0,2.0,2.0,2.0,3.0,15.0,1.0,2.0,1.0,7.0,6.0,12.0,0.0,0.0,2.0,4.0,61.0,1.0,1.0,20.0,32.0,0.0,0.0,108.0,0.0,1.0,,,8.0,,8.0,,,4.0,1.0,2.0,1.0,6.0,3.0,2.0,64.0,0.0,3.0,51.0,13.0,58.0,0.0,4.0,3.0,0.0,,10.0,0.0,0.0,60.0,181.0,,115.0,0.0,0.0,0.0,1.0,2.0,0.0,,0.0,5.0,5.0,1.0,3.0,1.0,,1.0,0.0
2024-06-13 00:00:00+00:00,89.0,,70.0,12.0,32.0,378.0,10.0,32.0,68.0,0.0,45.0,3.0,6.0,4.0,2.0,22.0,10.0,3.0,,2.0,0.0,0.0,2.0,25.0,4.0,0.0,13.0,,1.0,0.0,0.0,,,12.0,38.0,0.0,4.0,3.0,0.0,9.0,2.0,11.0,0.0,2.0,,4.0,1.0,17.0,3.0,,2.0,40.0,0.0,21.0,0.0,5.0,4.0,3.0,,0.0,4.0,1.0,2.0,1.0,5.0,2.0,18.0,0.0,0.0,4.0,3.0,3.0,14.0,1.0,0.0,0.0,2.0,47.0,2.0,1.0,12.0,11.0,0.0,0.0,54.0,0.0,4.0,,,11.0,,0.0,,,2.0,5.0,4.0,0.0,4.0,4.0,8.0,35.0,0.0,0.0,65.0,6.0,55.0,3.0,1.0,8.0,1.0,,4.0,0.0,1.0,77.0,151.0,,100.0,0.0,1.0,0.0,0.0,0.0,0.0,,2.0,6.0,10.0,0.0,6.0,1.0,,2.0,0.0
2024-06-14 00:00:00+00:00,85.0,,105.0,13.0,27.0,389.0,9.0,45.0,83.0,7.0,54.0,3.0,9.0,9.0,0.0,23.0,8.0,2.0,,2.0,0.0,1.0,28.0,33.0,1.0,2.0,9.0,,12.0,2.0,0.0,,,5.0,6.0,0.0,2.0,7.0,1.0,13.0,3.0,14.0,0.0,1.0,,44.0,1.0,15.0,1.0,,5.0,32.0,0.0,20.0,0.0,1.0,4.0,4.0,,0.0,1.0,1.0,2.0,1.0,4.0,5.0,20.0,3.0,1.0,8.0,2.0,8.0,12.0,0.0,0.0,3.0,3.0,56.0,1.0,0.0,4.0,18.0,1.0,0.0,44.0,0.0,3.0,,,15.0,,1.0,,,1.0,2.0,2.0,1.0,3.0,1.0,3.0,36.0,0.0,1.0,42.0,7.0,53.0,3.0,4.0,3.0,1.0,,5.0,0.0,0.0,67.0,173.0,,96.0,0.0,0.0,1.0,1.0,0.0,0.0,,0.0,4.0,0.0,2.0,3.0,0.0,,1.0,0.0
2024-06-15 00:00:00+00:00,63.0,,72.0,11.0,17.0,322.0,4.0,20.0,27.0,9.0,33.0,0.0,0.0,2.0,0.0,10.0,5.0,10.0,,1.0,0.0,3.0,4.0,14.0,0.0,0.0,2.0,,9.0,0.0,0.0,,,4.0,5.0,0.0,7.0,5.0,0.0,3.0,3.0,8.0,0.0,1.0,,10.0,0.0,11.0,4.0,,2.0,25.0,0.0,9.0,1.0,1.0,1.0,0.0,,0.0,1.0,0.0,1.0,1.0,0.0,4.0,6.0,1.0,1.0,0.0,10.0,0.0,5.0,0.0,1.0,2.0,0.0,26.0,0.0,0.0,0.0,14.0,0.0,0.0,33.0,0.0,0.0,,,2.0,,1.0,,,3.0,1.0,1.0,0.0,1.0,2.0,5.0,26.0,0.0,0.0,18.0,3.0,24.0,1.0,1.0,3.0,2.0,,9.0,0.0,0.0,31.0,129.0,,87.0,0.0,0.0,0.0,0.0,1.0,1.0,,0.0,0.0,2.0,0.0,3.0,0.0,,1.0,0.0
2024-06-16 00:00:00+00:00,57.0,,78.0,9.0,19.0,330.0,8.0,26.0,20.0,5.0,49.0,1.0,2.0,8.0,0.0,16.0,6.0,7.0,,0.0,0.0,8.0,5.0,26.0,6.0,3.0,3.0,,10.0,0.0,2.0,,,2.0,7.0,1.0,11.0,6.0,0.0,3.0,0.0,5.0,0.0,1.0,,12.0,3.0,8.0,2.0,,3.0,28.0,0.0,11.0,0.0,5.0,1.0,0.0,,0.0,0.0,4.0,0.0,2.0,1.0,4.0,12.0,0.0,0.0,4.0,7.0,3.0,11.0,0.0,1.0,2.0,1.0,49.0,0.0,0.0,0.0,3.0,0.0,0.0,32.0,0.0,3.0,,,6.0,,1.0,,,1.0,1.0,1.0,0.0,1.0,0.0,3.0,22.0,0.0,0.0,13.0,3.0,41.0,1.0,0.0,3.0,2.0,,1.0,0.0,0.0,52.0,129.0,,77.0,2.0,1.0,0.0,0.0,0.0,0.0,,0.0,2.0,6.0,3.0,1.0,0.0,,2.0,0.0
2024-06-17 00:00:00+00:00,75.0,,80.0,14.0,15.0,361.0,13.0,32.0,42.0,4.0,35.0,2.0,5.0,4.0,0.0,19.0,3.0,9.0,,2.0,0.0,2.0,18.0,22.0,61.0,0.0,3.0,,15.0,0.0,0.0,,,9.0,6.0,1.0,13.0,6.0,0.0,13.0,2.0,18.0,0.0,1.0,,11.0,1.0,7.0,0.0,,4.0,62.0,0.0,9.0,2.0,2.0,0.0,3.0,,0.0,2.0,3.0,3.0,3.0,2.0,6.0,16.0,2.0,0.0,4.0,9.0,1.0,10.0,1.0,0.0,4.0,4.0,67.0,0.0,2.0,3.0,9.0,0.0,0.0,50.0,0.0,1.0,,,9.0,,1.0,,,3.0,3.0,3.0,2.0,3.0,1.0,1.0,38.0,0.0,0.0,41.0,13.0,40.0,2.0,1.0,5.0,0.0,,3.0,0.0,1.0,59.0,148.0,,99.0,0.0,0.0,1.0,0.0,0.0,0.0,,0.0,2.0,4.0,3.0,3.0,0.0,,2.0,0.0
2024-06-18 00:00:00+00:00,114.0,,64.0,17.0,27.0,354.0,27.0,34.0,49.0,3.0,52.0,1.0,2.0,8.0,2.0,21.0,2.0,7.0,,6.0,0.0,2.0,9.0,20.0,7.0,2.0,2.0,,11.0,0.0,0.0,,,17.0,1.0,0.0,2.0,11.0,0.0,9.0,3.0,22.0,0.0,2.0,,5.0,1.0,21.0,1.0,,8.0,121.0,0.0,14.0,0.0,0.0,3.0,5.0,,1.0,2.0,2.0,2.0,5.0,2.0,8.0,15.0,1.0,0.0,6.0,7.0,2.0,12.0,1.0,1.0,1.0,13.0,58.0,1.0,0.0,0.0,4.0,0.0,0.0,48.0,0.0,5.0,,,8.0,,1.0,,,1.0,1.0,1.0,0.0,4.0,2.0,7.0,39.0,1.0,0.0,34.0,6.0,70.0,0.0,1.0,2.0,2.0,,8.0,0.0,2.0,42.0,140.0,,92.0,1.0,3.0,1.0,0.0,0.0,0.0,,2.0,3.0,6.0,3.0,3.0,0.0,,1.0,0.0
2024-06-19 00:00:00+00:00,78.0,,91.0,12.0,25.0,360.0,10.0,32.0,38.0,55.0,36.0,3.0,1.0,30.0,0.0,26.0,6.0,7.0,,0.0,0.0,2.0,7.0,24.0,23.0,1.0,3.0,,17.0,2.0,0.0,,,3.0,7.0,1.0,9.0,5.0,0.0,5.0,1.0,8.0,1.0,1.0,,16.0,1.0,29.0,6.0,,3.0,56.0,0.0,9.0,0.0,1.0,2.0,2.0,,1.0,0.0,4.0,4.0,1.0,1.0,1.0,14.0,0.0,2.0,6.0,7.0,1.0,17.0,0.0,0.0,0.0,8.0,40.0,2.0,1.0,1.0,26.0,0.0,0.0,47.0,0.0,3.0,,,13.0,,0.0,,,3.0,2.0,2.0,2.0,2.0,2.0,9.0,37.0,2.0,1.0,19.0,2.0,71.0,2.0,1.0,4.0,0.0,,2.0,0.0,1.0,67.0,174.0,,87.0,2.0,0.0,2.0,0.0,2.0,2.0,,1.0,1.0,0.0,3.0,3.0,0.0,,0.0,0.0
2024-06-20 00:00:00+00:00,96.0,,70.0,6.0,26.0,365.0,13.0,40.0,21.0,11.0,19.0,4.0,7.0,21.0,1.0,23.0,2.0,10.0,,3.0,0.0,3.0,12.0,15.0,4.0,0.0,3.0,,5.0,0.0,1.0,,,4.0,4.0,1.0,8.0,6.0,0.0,6.0,3.0,15.0,0.0,3.0,,3.0,1.0,13.0,0.0,,4.0,65.0,0.0,8.0,1.0,0.0,8.0,0.0,,1.0,0.0,1.0,3.0,5.0,2.0,2.0,10.0,0.0,3.0,4.0,10.0,1.0,16.0,0.0,0.0,0.0,5.0,37.0,1.0,0.0,1.0,6.0,0.0,0.0,54.0,0.0,7.0,,,16.0,,1.0,,,1.0,3.0,0.0,0.0,4.0,1.0,7.0,37.0,0.0,0.0,28.0,17.0,53.0,2.0,15.0,9.0,0.0,,2.0,0.0,1.0,63.0,182.0,,103.0,0.0,0.0,3.0,0.0,0.0,0.0,,2.0,2.0,6.0,3.0,4.0,2.0,,1.0,0.0
2024-06-21 00:00:00+00:00,68.0,,56.0,9.0,20.0,352.0,7.0,26.0,34.0,15.0,47.0,8.0,8.0,17.0,0.0,20.0,6.0,5.0,,1.0,0.0,0.0,9.0,20.0,4.0,1.0,1.0,,11.0,2.0,0.0,,,11.0,5.0,1.0,5.0,7.0,0.0,4.0,2.0,23.0,0.0,0.0,,1.0,4.0,13.0,4.0,,2.0,34.0,0.0,12.0,1.0,21.0,0.0,0.0,,0.0,0.0,3.0,0.0,4.0,3.0,3.0,21.0,0.0,3.0,2.0,5.0,1.0,19.0,1.0,0.0,5.0,4.0,41.0,2.0,1.0,0.0,3.0,0.0,0.0,52.0,0.0,5.0,,,6.0,,0.0,,,0.0,3.0,1.0,0.0,3.0,6.0,4.0,42.0,1.0,0.0,22.0,7.0,60.0,1.0,0.0,2.0,0.0,,3.0,0.0,3.0,51.0,152.0,,118.0,0.0,0.0,1.0,0.0,0.0,0.0,,2.0,1.0,4.0,1.0,4.0,0.0,,1.0,0.0
2024-06-22 00:00:00+00:00,86.0,,53.0,6.0,14.0,275.0,3.0,26.0,23.0,9.0,28.0,1.0,3.0,9.0,1.0,28.0,4.0,3.0,,0.0,0.0,0.0,2.0,16.0,5.0,0.0,1.0,,14.0,0.0,1.0,,,3.0,1.0,2.0,13.0,4.0,0.0,4.0,4.0,16.0,0.0,1.0,,1.0,2.0,7.0,1.0,,2.0,47.0,0.0,10.0,1.0,5.0,1.0,0.0,,0.0,0.0,1.0,0.0,4.0,0.0,2.0,17.0,0.0,10.0,3.0,3.0,0.0,15.0,1.0,1.0,1.0,2.0,33.0,4.0,0.0,0.0,5.0,0.0,0.0,41.0,0.0,1.0,,,4.0,,1.0,,,1.0,0.0,0.0,0.0,0.0,2.0,3.0,21.0,0.0,0.0,23.0,0.0,72.0,1.0,0.0,1.0,2.0,,2.0,0.0,0.0,30.0,126.0,,88.0,1.0,0.0,0.0,1.0,0.0,0.0,,1.0,0.0,0.0,0.0,3.0,0.0,,0.0,0.0
2024-06-23 00:00:00+00:00,57.0,,54.0,16.0,17.0,279.0,7.0,41.0,13.0,7.0,19.0,0.0,3.0,8.0,0.0,10.0,9.0,1.0,,0.0,0.0,1.0,3.0,2.0,3.0,0.0,3.0,,0.0,0.0,1.0,,,3.0,2.0,3.0,2.0,3.0,0.0,8.0,1.0,7.0,0.0,1.0,,0.0,1.0,9.0,1.0,,5.0,36.0,1.0,7.0,1.0,3.0,4.0,0.0,,1.0,0.0,0.0,0.0,2.0,6.0,1.0,11.0,0.0,2.0,2.0,1.0,1.0,8.0,0.0,1.0,1.0,0.0,37.0,0.0,0.0,3.0,0.0,0.0,0.0,47.0,0.0,3.0,,,5.0,,1.0,,,0.0,1.0,0.0,0.0,2.0,1.0,0.0,22.0,2.0,0.0,9.0,3.0,44.0,0.0,1.0,2.0,0.0,,0.0,0.0,0.0,25.0,126.0,,85.0,1.0,1.0,0.0,0.0,0.0,2.0,,0.0,0.0,1.0,1.0,3.0,0.0,,1.0,0.0
2024-06-24 00:00:00+00:00,92.0,,48.0,14.0,29.0,309.0,13.0,35.0,53.0,22.0,36.0,4.0,10.0,12.0,2.0,23.0,3.0,13.0,,1.0,0.0,2.0,5.0,25.0,2.0,1.0,4.0,,3.0,0.0,0.0,,,4.0,2.0,0.0,6.0,4.0,1.0,12.0,6.0,26.0,0.0,3.0,,8.0,1.0,24.0,1.0,,2.0,47.0,3.0,18.0,0.0,2.0,3.0,0.0,,0.0,0.0,0.0,0.0,3.0,1.0,1.0,14.0,0.0,5.0,4.0,13.0,3.0,5.0,0.0,0.0,2.0,7.0,46.0,1.0,0.0,3.0,4.0,0.0,0.0,66.0,0.0,1.0,,,8.0,,1.0,,,1.0,0.0,0.0,0.0,1.0,10.0,5.0,46.0,1.0,0.0,14.0,15.0,64.0,3.0,0.0,1.0,0.0,,3.0,0.0,1.0,29.0,135.0,,109.0,1.0,1.0,1.0,0.0,0.0,0.0,,0.0,4.0,2.0,2.0,9.0,1.0,,1.0,0.0
2024-06-25 00:00:00+00:00,79.0,,48.0,23.0,31.0,326.0,5.0,32.0,38.0,15.0,26.0,5.0,3.0,12.0,0.0,20.0,5.0,4.0,,2.0,0.0,1.0,3.0,18.0,2.0,3.0,3.0,,13.0,1.0,0.0,,,8.0,0.0,1.0,7.0,8.0,0.0,6.0,3.0,16.0,0.0,5.0,,0.0,1.0,16.0,1.0,,1.0,62.0,0.0,7.0,0.0,0.0,3.0,1.0,,1.0,0.0,3.0,2.0,1.0,1.0,4.0,16.0,0.0,1.0,7.0,4.0,2.0,18.0,0.0,0.0,3.0,4.0,60.0,0.0,1.0,1.0,2.0,0.0,0.0,43.0,0.0,3.0,,,9.0,,0.0,,,1.0,4.0,2.0,0.0,2.0,7.0,3.0,51.0,6.0,1.0,37.0,12.0,66.0,2.0,1.0,4.0,0.0,,1.0,0.0,1.0,35.0,139.0,,90.0,0.0,0.0,0.0,0.0,0.0,1.0,,0.0,2.0,2.0,14.0,6.0,0.0,,1.0,0.0
2024-06-26 00:00:00+00:00,72.0,,60.0,7.0,29.0,356.0,6.0,34.0,42.0,10.0,47.0,2.0,3.0,11.0,0.0,8.0,3.0,6.0,,3.0,0.0,1.0,2.0,11.0,3.0,1.0,3.0,,9.0,1.0,1.0,,,7.0,8.0,2.0,16.0,6.0,0.0,7.0,4.0,20.0,0.0,0.0,,6.0,0.0,23.0,2.0,,4.0,82.0,0.0,4.0,2.0,2.0,3.0,2.0,,1.0,0.0,0.0,2.0,2.0,2.0,3.0,10.0,1.0,2.0,5.0,6.0,2.0,22.0,0.0,2.0,3.0,1.0,45.0,3.0,0.0,1.0,10.0,0.0,0.0,32.0,0.0,2.0,,,12.0,,0.0,,,0.0,5.0,1.0,2.0,4.0,2.0,2.0,30.0,2.0,1.0,23.0,6.0,79.0,1.0,9.0,4.0,1.0,,3.0,1.0,0.0,49.0,139.0,,114.0,0.0,0.0,0.0,0.0,1.0,0.0,,0.0,3.0,5.0,0.0,4.0,0.0,,3.0,0.0
2024-06-27 00:00:00+00:00,88.0,,57.0,15.0,21.0,404.0,13.0,59.0,35.0,20.0,29.0,6.0,2.0,9.0,0.0,30.0,4.0,22.0,,3.0,0.0,1.0,8.0,18.0,2.0,4.0,1.0,,4.0,1.0,2.0,,,5.0,5.0,3.0,11.0,5.0,1.0,11.0,3.0,7.0,0.0,0.0,,2.0,1.0,28.0,3.0,,3.0,68.0,0.0,12.0,2.0,0.0,2.0,6.0,,0.0,0.0,1.0,0.0,2.0,2.0,11.0,10.0,1.0,1.0,4.0,22.0,2.0,16.0,0.0,0.0,3.0,9.0,36.0,1.0,0.0,1.0,2.0,0.0,0.0,46.0,0.0,3.0,,,6.0,,1.0,,,0.0,2.0,0.0,1.0,1.0,2.0,2.0,38.0,1.0,0.0,25.0,12.0,60.0,1.0,0.0,1.0,0.0,,4.0,0.0,2.0,57.0,127.0,,92.0,0.0,0.0,0.0,0.0,1.0,0.0,,0.0,5.0,6.0,8.0,5.0,0.0,,3.0,0.0
2024-06-28 00:00:00+00:00,61.0,,46.0,16.0,16.0,341.0,2.0,26.0,19.0,28.0,26.0,3.0,9.0,3.0,0.0,11.0,3.0,6.0,,2.0,0.0,2.0,1.0,8.0,5.0,1.0,1.0,,2.0,2.0,3.0,,,4.0,14.0,0.0,2.0,7.0,0.0,10.0,4.0,27.0,0.0,2.0,,27.0,2.0,22.0,5.0,,2.0,36.0,0.0,14.0,1.0,0.0,1.0,1.0,,0.0,4.0,0.0,1.0,3.0,0.0,3.0,12.0,1.0,0.0,2.0,6.0,0.0,12.0,1.0,1.0,1.0,6.0,21.0,1.0,0.0,1.0,1.0,0.0,0.0,41.0,0.0,0.0,,,12.0,,0.0,,,1.0,1.0,2.0,2.0,2.0,2.0,0.0,37.0,1.0,1.0,34.0,7.0,71.0,1.0,3.0,5.0,0.0,,7.0,0.0,0.0,59.0,133.0,,97.0,0.0,0.0,0.0,0.0,1.0,0.0,,0.0,3.0,1.0,2.0,6.0,1.0,,0.0,0.0
2024-06-29 00:00:00+00:00,48.0,,39.0,7.0,17.0,278.0,0.0,15.0,32.0,12.0,35.0,4.0,2.0,2.0,1.0,14.0,3.0,7.0,,7.0,0.0,0.0,2.0,6.0,1.0,0.0,2.0,,3.0,0.0,0.0,,,5.0,5.0,1.0,8.0,6.0,0.0,3.0,2.0,12.0,0.0,0.0,,15.0,0.0,29.0,0.0,,1.0,40.0,0.0,15.0,0.0,3.0,1.0,0.0,,0.0,0.0,0.0,2.0,1.0,1.0,2.0,12.0,0.0,0.0,2.0,7.0,1.0,12.0,3.0,0.0,2.0,1.0,40.0,1.0,1.0,1.0,2.0,0.0,0.0,35.0,0.0,2.0,,,9.0,,1.0,,,0.0,1.0,0.0,1.0,0.0,1.0,2.0,26.0,0.0,0.0,9.0,3.0,65.0,0.0,3.0,1.0,2.0,,7.0,0.0,0.0,24.0,105.0,,95.0,0.0,0.0,5.0,0.0,0.0,0.0,,0.0,1.0,0.0,0.0,7.0,0.0,,1.0,0.0
2024-06-30 00:00:00+00:00,48.0,,58.0,5.0,10.0,283.0,4.0,19.0,20.0,6.0,25.0,1.0,1.0,1.0,0.0,7.0,3.0,8.0,,5.0,0.0,1.0,1.0,32.0,1.0,0.0,0.0,,13.0,0.0,0.0,,,3.0,4.0,0.0,8.0,8.0,0.0,12.0,2.0,12.0,0.0,0.0,,2.0,1.0,15.0,1.0,,0.0,39.0,0.0,10.0,1.0,1.0,1.0,1.0,,0.0,0.0,0.0,0.0,1.0,3.0,0.0,8.0,1.0,1.0,1.0,8.0,1.0,20.0,0.0,0.0,1.0,1.0,43.0,0.0,0.0,0.0,6.0,0.0,0.0,38.0,0.0,0.0,,,15.0,,1.0,,,0.0,0.0,1.0,1.0,1.0,1.0,0.0,30.0,1.0,0.0,11.0,3.0,52.0,5.0,1.0,0.0,0.0,,8.0,0.0,0.0,25.0,96.0,,58.0,0.0,0.0,0.0,0.0,0.0,0.0,,0.0,1.0,0.0,0.0,7.0,0.0,,2.0,0.0
2024-07-01 00:00:00+00:00,84.0,,47.0,19.0,16.0,356.0,9.0,27.0,27.0,6.0,37.0,3.0,7.0,9.0,0.0,16.0,3.0,16.0,,4.0,0.0,2.0,1.0,16.0,17.0,2.0,2.0,,16.0,3.0,0.0,,,7.0,4.0,0.0,10.0,7.0,1.0,9.0,2.0,10.0,0.0,1.0,,6.0,1.0,14.0,2.0,,0.0,54.0,0.0,6.0,0.0,2.0,3.0,2.0,,0.0,0.0,2.0,0.0,14.0,2.0,1.0,18.0,0.0,3.0,7.0,16.0,1.0,12.0,1.0,0.0,4.0,7.0,41.0,2.0,0.0,2.0,0.0,0.0,0.0,44.0,0.0,1.0,,,4.0,,1.0,,,1.0,2.0,0.0,0.0,3.0,3.0,24.0,36.0,1.0,1.0,19.0,7.0,56.0,2.0,5.0,5.0,9.0,,3.0,0.0,1.0,38.0,132.0,,93.0,0.0,0.0,0.0,0.0,0.0,0.0,,0.0,0.0,5.0,0.0,4.0,0.0,,2.0,0.0
2024-07-02 00:00:00+00:00,84.0,,49.0,25.0,12.0,380.0,7.0,19.0,21.0,4.0,41.0,2.0,2.0,9.0,0.0,14.0,2.0,5.0,,2.0,0.0,3.0,3.0,26.0,1.0,6.0,3.0,,65.0,1.0,2.0,,,6.0,4.0,1.0,4.0,9.0,0.0,3.0,4.0,7.0,0.0,6.0,,3.0,0.0,17.0,0.0,,3.0,55.0,0.0,7.0,0.0,0.0,3.0,1.0,,0.0,0.0,0.0,7.0,8.0,1.0,0.0,11.0,0.0,0.0,7.0,5.0,1.0,15.0,0.0,1.0,3.0,3.0,60.0,3.0,0.0,2.0,2.0,0.0,0.0,64.0,0.0,2.0,,,15.0,,2.0,,,3.0,2.0,2.0,0.0,1.0,8.0,10.0,37.0,1.0,5.0,21.0,7.0,43.0,1.0,0.0,1.0,2.0,,1.0,0.0,1.0,48.0,151.0,,86.0,0.0,0.0,0.0,0.0,0.0,0.0,,1.0,3.0,1.0,1.0,4.0,0.0,,1.0,0.0
2024-07-03 00:00:00+00:00,119.0,,42.0,10.0,5.0,402.0,4.0,15.0,23.0,7.0,26.0,3.0,6.0,11.0,0.0,20.0,0.0,4.0,,1.0,0.0,5.0,2.0,13.0,4.0,1.0,2.0,,53.0,1.0,0.0,,,3.0,6.0,0.0,3.0,4.0,1.0,6.0,4.0,16.0,0.0,2.0,,3.0,0.0,20.0,0.0,,1.0,65.0,0.0,16.0,1.0,0.0,7.0,1.0,,0.0,0.0,1.0,7.0,10.0,1.0,5.0,16.0,0.0,2.0,4.0,4.0,2.0,6.0,0.0,1.0,0.0,3.0,48.0,0.0,0.0,2.0,7.0,0.0,0.0,54.0,0.0,5.0,,,11.0,,0.0,,,1.0,1.0,0.0,1.0,2.0,1.0,4.0,34.0,2.0,1.0,34.0,6.0,62.0,3.0,0.0,3.0,0.0,,3.0,0.0,0.0,34.0,166.0,,75.0,0.0,0.0,0.0,0.0,1.0,5.0,,0.0,2.0,2.0,1.0,5.0,0.0,,1.0,0.0
2024-07-04 00:00:00+00:00,82.0,,45.0,10.0,18.0,398.0,3.0,29.0,16.0,14.0,35.0,0.0,4.0,8.0,0.0,19.0,1.0,3.0,,0.0,0.0,4.0,0.0,27.0,0.0,0.0,2.0,,13.0,1.0,1.0,,,4.0,7.0,1.0,2.0,5.0,0.0,12.0,5.0,24.0,0.0,1.0,,7.0,1.0,26.0,0.0,,3.0,104.0,0.0,14.0,1.0,0.0,3.0,1.0,,0.0,0.0,0.0,1.0,4.0,0.0,6.0,14.0,0.0,0.0,2.0,3.0,1.0,11.0,0.0,0.0,2.0,11.0,37.0,3.0,0.0,1.0,1.0,0.0,0.0,48.0,0.0,0.0,,,8.0,,0.0,,,0.0,2.0,2.0,0.0,0.0,2.0,2.0,39.0,0.0,1.0,40.0,2.0,49.0,0.0,21.0,0.0,0.0,,6.0,0.0,0.0,35.0,144.0,,101.0,2.0,1.0,2.0,0.0,0.0,1.0,,1.0,3.0,4.0,1.0,5.0,0.0,,0.0,0.0
2024-07-05 00:00:00+00:00,53.0,,69.0,12.0,17.0,304.0,7.0,40.0,31.0,3.0,35.0,1.0,2.0,11.0,0.0,18.0,1.0,12.0,,2.0,0.0,1.0,2.0,37.0,8.0,0.0,2.0,,23.0,0.0,1.0,,,0.0,4.0,1.0,12.0,2.0,1.0,6.0,3.0,18.0,0.0,0.0,,1.0,2.0,23.0,1.0,,0.0,65.0,2.0,11.0,0.0,3.0,2.0,2.0,,0.0,0.0,0.0,1.0,4.0,1.0,3.0,6.0,0.0,0.0,4.0,12.0,0.0,7.0,0.0,1.0,0.0,9.0,39.0,0.0,0.0,0.0,9.0,0.0,0.0,44.0,0.0,2.0,,,7.0,,0.0,,,1.0,1.0,1.0,1.0,1.0,3.0,3.0,48.0,2.0,0.0,16.0,3.0,60.0,1.0,4.0,3.0,0.0,,0.0,0.0,2.0,38.0,176.0,,111.0,0.0,1.0,0.0,2.0,0.0,0.0,,0.0,1.0,1.0,1.0,4.0,0.0,,4.0,0.0
2024-07-06 00:00:00+00:00,65.0,,44.0,12.0,14.0,291.0,2.0,15.0,41.0,2.0,30.0,5.0,1.0,1.0,1.0,15.0,4.0,3.0,,0.0,0.0,2.0,3.0,5.0,2.0,1.0,1.0,,2.0,0.0,0.0,,,3.0,2.0,0.0,1.0,7.0,1.0,3.0,2.0,8.0,0.0,1.0,,10.0,0.0,13.0,0.0,,1.0,35.0,0.0,9.0,1.0,0.0,3.0,1.0,,0.0,0.0,1.0,4.0,4.0,0.0,2.0,10.0,0.0,1.0,3.0,3.0,0.0,12.0,0.0,0.0,2.0,4.0,24.0,3.0,1.0,1.0,0.0,0.0,0.0,22.0,0.0,1.0,,,8.0,,0.0,,,0.0,0.0,0.0,1.0,1.0,4.0,0.0,19.0,0.0,0.0,5.0,2.0,64.0,2.0,0.0,3.0,1.0,,5.0,0.0,0.0,30.0,137.0,,84.0,1.0,0.0,2.0,0.0,0.0,0.0,,0.0,1.0,0.0,3.0,2.0,0.0,,3.0,0.0
2024-07-07 00:00:00+00:00,30.0,,48.0,12.0,6.0,278.0,1.0,12.0,75.0,3.0,19.0,0.0,4.0,6.0,0.0,12.0,3.0,6.0,,1.0,0.0,0.0,28.0,9.0,0.0,1.0,30.0,,11.0,0.0,0.0,,,8.0,2.0,1.0,7.0,4.0,0.0,3.0,2.0,15.0,0.0,0.0,,6.0,0.0,8.0,1.0,,0.0,54.0,0.0,8.0,3.0,0.0,2.0,2.0,,0.0,0.0,0.0,1.0,0.0,0.0,1.0,7.0,0.0,2.0,4.0,6.0,2.0,13.0,0.0,0.0,2.0,2.0,27.0,1.0,0.0,0.0,2.0,0.0,0.0,38.0,0.0,1.0,,,4.0,,3.0,,,0.0,1.0,2.0,0.0,0.0,2.0,2.0,26.0,0.0,0.0,10.0,1.0,34.0,3.0,21.0,0.0,1.0,,1.0,0.0,1.0,22.0,122.0,,90.0,1.0,0.0,1.0,0.0,0.0,2.0,,0.0,0.0,0.0,1.0,4.0,2.0,,0.0,0.0
2024-07-08 00:00:00+00:00,91.0,,48.0,3.0,9.0,370.0,11.0,33.0,20.0,2.0,37.0,2.0,2.0,9.0,4.0,17.0,3.0,6.0,,1.0,0.0,3.0,12.0,9.0,2.0,2.0,10.0,,6.0,0.0,4.0,,,3.0,1.0,0.0,5.0,8.0,1.0,5.0,2.0,24.0,0.0,2.0,,7.0,2.0,14.0,1.0,,2.0,46.0,0.0,4.0,0.0,0.0,5.0,1.0,,1.0,0.0,5.0,0.0,5.0,1.0,4.0,15.0,1.0,2.0,11.0,6.0,1.0,15.0,1.0,2.0,0.0,1.0,37.0,0.0,0.0,0.0,18.0,0.0,0.0,50.0,0.0,4.0,,,6.0,,1.0,,,4.0,2.0,1.0,1.0,1.0,3.0,8.0,38.0,0.0,0.0,15.0,3.0,62.0,1.0,0.0,3.0,12.0,,1.0,0.0,0.0,29.0,128.0,,80.0,0.0,0.0,0.0,0.0,0.0,0.0,,0.0,0.0,1.0,0.0,3.0,0.0,,4.0,1.0
2024-07-09 00:00:00+00:00,90.0,,41.0,20.0,13.0,358.0,9.0,27.0,22.0,4.0,40.0,4.0,4.0,3.0,5.0,19.0,3.0,5.0,,2.0,0.0,0.0,2.0,8.0,0.0,1.0,2.0,,4.0,3.0,0.0,,,8.0,2.0,3.0,6.0,8.0,1.0,3.0,2.0,8.0,0.0,2.0,,6.0,2.0,13.0,1.0,,4.0,40.0,0.0,10.0,0.0,0.0,3.0,3.0,,0.0,0.0,12.0,2.0,3.0,1.0,4.0,12.0,1.0,0.0,4.0,5.0,0.0,8.0,0.0,1.0,3.0,0.0,68.0,3.0,1.0,0.0,18.0,0.0,0.0,31.0,0.0,3.0,,,11.0,,0.0,,,0.0,0.0,1.0,0.0,2.0,3.0,5.0,39.0,2.0,0.0,24.0,4.0,48.0,0.0,2.0,2.0,6.0,,0.0,0.0,0.0,26.0,119.0,,82.0,2.0,0.0,0.0,0.0,0.0,0.0,,1.0,0.0,3.0,0.0,4.0,0.0,,1.0,0.0
2024-07-10 00:00:00+00:00,66.0,,52.0,13.0,14.0,366.0,3.0,23.0,21.0,1.0,41.0,2.0,5.0,5.0,1.0,12.0,6.0,8.0,,3.0,0.0,1.0,9.0,16.0,2.0,2.0,3.0,,3.0,12.0,0.0,,,9.0,3.0,1.0,1.0,2.0,1.0,9.0,3.0,12.0,0.0,1.0,,3.0,5.0,22.0,2.0,,2.0,98.0,0.0,5.0,4.0,2.0,3.0,2.0,,1.0,0.0,3.0,0.0,1.0,2.0,4.0,16.0,1.0,0.0,7.0,8.0,2.0,15.0,0.0,1.0,1.0,0.0,41.0,1.0,1.0,2.0,16.0,0.0,0.0,32.0,0.0,5.0,,,8.0,,0.0,,,0.0,1.0,0.0,0.0,4.0,3.0,0.0,51.0,4.0,2.0,15.0,1.0,48.0,1.0,1.0,3.0,2.0,,0.0,0.0,0.0,47.0,109.0,,90.0,0.0,0.0,0.0,0.0,0.0,0.0,,0.0,5.0,0.0,0.0,3.0,0.0,,1.0,0.0
2024-07-11 00:00:00+00:00,112.0,,52.0,13.0,26.0,350.0,2.0,23.0,17.0,8.0,27.0,6.0,10.0,29.0,0.0,21.0,4.0,9.0,,3.0,1.0,4.0,5.0,44.0,4.0,0.0,1.0,,16.0,4.0,0.0,,,4.0,2.0,1.0,9.0,6.0,0.0,5.0,1.0,10.0,0.0,1.0,,6.0,0.0,20.0,0.0,,4.0,47.0,0.0,6.0,2.0,1.0,1.0,2.0,,1.0,1.0,8.0,0.0,6.0,0.0,8.0,11.0,2.0,4.0,5.0,9.0,1.0,18.0,1.0,0.0,3.0,0.0,62.0,1.0,1.0,1.0,20.0,0.0,0.0,55.0,0.0,1.0,,,12.0,,0.0,,,1.0,1.0,0.0,0.0,1.0,1.0,4.0,27.0,2.0,0.0,15.0,3.0,70.0,0.0,2.0,4.0,2.0,,3.0,0.0,0.0,44.0,163.0,,104.0,0.0,0.0,0.0,0.0,0.0,0.0,,0.0,7.0,3.0,6.0,3.0,1.0,,1.0,1.0
2024-07-12 00:00:00+00:00,72.0,,52.0,20.0,14.0,340.0,3.0,41.0,16.0,7.0,22.0,5.0,2.0,68.0,0.0,10.0,0.0,6.0,,7.0,0.0,9.0,3.0,18.0,0.0,0.0,0.0,,5.0,0.0,1.0,,,5.0,2.0,4.0,3.0,6.0,1.0,3.0,1.0,17.0,0.0,1.0,,1.0,1.0,19.0,2.0,,0.0,51.0,0.0,11.0,5.0,0.0,2.0,1.0,,0.0,1.0,3.0,2.0,7.0,0.0,2.0,6.0,0.0,0.0,3.0,6.0,1.0,16.0,0.0,0.0,4.0,1.0,35.0,2.0,0.0,0.0,12.0,0.0,0.0,38.0,0.0,3.0,,,8.0,,1.0,,,1.0,2.0,3.0,5.0,3.0,2.0,1.0,33.0,0.0,0.0,16.0,2.0,73.0,1.0,4.0,5.0,2.0,,8.0,0.0,1.0,31.0,118.0,,103.0,0.0,0.0,0.0,0.0,0.0,0.0,,0.0,1.0,1.0,5.0,7.0,0.0,,0.0,0.0
2024-07-13 00:00:00+00:00,63.0,,38.0,4.0,14.0,417.0,9.0,32.0,22.0,5.0,23.0,1.0,3.0,26.0,0.0,15.0,3.0,8.0,,0.0,0.0,3.0,0.0,8.0,0.0,1.0,0.0,,3.0,0.0,2.0,,,2.0,2.0,3.0,5.0,6.0,0.0,3.0,2.0,8.0,0.0,2.0,,10.0,0.0,13.0,0.0,,1.0,29.0,0.0,2.0,8.0,2.0,2.0,0.0,,0.0,1.0,0.0,1.0,3.0,0.0,1.0,6.0,0.0,4.0,1.0,8.0,0.0,9.0,1.0,0.0,1.0,3.0,39.0,0.0,1.0,0.0,16.0,0.0,0.0,33.0,0.0,0.0,,,8.0,,0.0,,,1.0,1.0,4.0,1.0,1.0,0.0,3.0,29.0,0.0,1.0,17.0,1.0,56.0,1.0,5.0,1.0,4.0,,5.0,0.0,0.0,12.0,111.0,,97.0,1.0,0.0,1.0,0.0,1.0,1.0,,0.0,1.0,2.0,0.0,4.0,1.0,,0.0,0.0
2024-07-14 00:00:00+00:00,42.0,,33.0,13.0,6.0,445.0,7.0,25.0,17.0,3.0,28.0,0.0,3.0,23.0,2.0,13.0,2.0,3.0,,0.0,0.0,0.0,5.0,4.0,0.0,0.0,5.0,,13.0,0.0,0.0,,,1.0,2.0,0.0,5.0,7.0,0.0,3.0,0.0,12.0,0.0,0.0,,3.0,0.0,16.0,1.0,,0.0,28.0,0.0,14.0,2.0,0.0,2.0,0.0,,0.0,0.0,0.0,2.0,5.0,1.0,1.0,10.0,0.0,3.0,2.0,3.0,2.0,6.0,0.0,0.0,1.0,0.0,40.0,0.0,0.0,0.0,0.0,0.0,0.0,28.0,0.0,2.0,,,4.0,,2.0,,,0.0,1.0,1.0,0.0,0.0,1.0,1.0,25.0,0.0,1.0,9.0,2.0,30.0,2.0,1.0,0.0,1.0,,3.0,0.0,0.0,44.0,108.0,,66.0,2.0,0.0,0.0,0.0,0.0,0.0,,0.0,3.0,1.0,0.0,8.0,0.0,,0.0,0.0
2024-07-15 00:00:00+00:00,88.0,,60.0,7.0,23.0,350.0,12.0,30.0,36.0,5.0,40.0,2.0,14.0,25.0,0.0,18.0,0.0,7.0,,5.0,1.0,2.0,0.0,10.0,2.0,1.0,9.0,,2.0,0.0,0.0,,,1.0,2.0,0.0,4.0,3.0,0.0,7.0,0.0,14.0,0.0,4.0,,7.0,1.0,12.0,0.0,,2.0,53.0,0.0,4.0,3.0,4.0,3.0,1.0,,0.0,1.0,0.0,1.0,1.0,1.0,4.0,15.0,1.0,2.0,6.0,7.0,1.0,10.0,2.0,0.0,1.0,18.0,37.0,1.0,0.0,0.0,3.0,2.0,0.0,67.0,0.0,1.0,,,5.0,,1.0,,,1.0,2.0,3.0,4.0,2.0,2.0,2.0,35.0,1.0,0.0,10.0,1.0,57.0,3.0,16.0,1.0,0.0,,0.0,0.0,0.0,21.0,114.0,,77.0,0.0,0.0,0.0,0.0,0.0,0.0,,0.0,2.0,4.0,1.0,6.0,0.0,,2.0,0.0
2024-07-16 00:00:00+00:00,56.0,,65.0,9.0,8.0,289.0,6.0,29.0,27.0,11.0,40.0,2.0,2.0,19.0,0.0,16.0,2.0,5.0,,3.0,0.0,1.0,3.0,23.0,2.0,2.0,1.0,,16.0,1.0,1.0,,,3.0,4.0,0.0,8.0,6.0,1.0,2.0,1.0,18.0,0.0,0.0,,2.0,0.0,18.0,0.0,,0.0,57.0,1.0,7.0,2.0,2.0,0.0,0.0,,2.0,8.0,4.0,2.0,2.0,1.0,2.0,15.0,1.0,0.0,7.0,5.0,0.0,9.0,1.0,0.0,1.0,3.0,31.0,0.0,1.0,0.0,4.0,1.0,0.0,51.0,1.0,1.0,,,4.0,,1.0,,,2.0,3.0,2.0,0.0,2.0,1.0,3.0,36.0,1.0,0.0,26.0,3.0,29.0,6.0,0.0,3.0,0.0,,3.0,0.0,1.0,56.0,136.0,,69.0,4.0,0.0,0.0,1.0,0.0,2.0,,0.0,4.0,4.0,4.0,3.0,0.0,,0.0,0.0
2024-07-17 00:00:00+00:00,53.0,,49.0,9.0,13.0,317.0,4.0,31.0,26.0,5.0,29.0,1.0,7.0,6.0,0.0,10.0,3.0,7.0,,4.0,0.0,0.0,0.0,15.0,2.0,2.0,4.0,,17.0,1.0,0.0,,,3.0,1.0,2.0,5.0,11.0,0.0,9.0,1.0,11.0,0.0,2.0,,3.0,1.0,20.0,0.0,,2.0,59.0,1.0,7.0,3.0,0.0,1.0,0.0,,0.0,1.0,16.0,5.0,1.0,1.0,1.0,14.0,0.0,0.0,1.0,7.0,2.0,12.0,0.0,0.0,1.0,4.0,27.0,2.0,1.0,0.0,10.0,0.0,0.0,49.0,0.0,4.0,,,3.0,,0.0,,,0.0,2.0,2.0,1.0,2.0,0.0,3.0,35.0,1.0,1.0,25.0,3.0,59.0,2.0,0.0,0.0,3.0,,1.0,1.0,1.0,71.0,132.0,,105.0,1.0,0.0,2.0,0.0,0.0,2.0,,0.0,1.0,2.0,4.0,8.0,0.0,,4.0,0.0
2024-07-18 00:00:00+00:00,70.0,,56.0,14.0,8.0,308.0,4.0,22.0,24.0,10.0,27.0,1.0,5.0,2.0,1.0,13.0,1.0,6.0,,0.0,0.0,2.0,3.0,22.0,1.0,2.0,2.0,,7.0,0.0,0.0,,,3.0,3.0,0.0,4.0,3.0,0.0,7.0,1.0,20.0,0.0,4.0,,7.0,0.0,18.0,1.0,,3.0,44.0,0.0,15.0,2.0,1.0,2.0,0.0,,0.0,0.0,5.0,1.0,3.0,0.0,6.0,12.0,0.0,0.0,4.0,6.0,0.0,11.0,1.0,0.0,0.0,3.0,24.0,4.0,0.0,0.0,6.0,0.0,0.0,44.0,0.0,0.0,,,11.0,,0.0,,,2.0,1.0,0.0,0.0,2.0,0.0,1.0,28.0,0.0,0.0,12.0,2.0,40.0,4.0,1.0,2.0,5.0,,2.0,0.0,1.0,43.0,135.0,,74.0,0.0,1.0,1.0,0.0,1.0,1.0,,1.0,5.0,2.0,6.0,6.0,0.0,,0.0,0.0
2024-07-19 00:00:00+00:00,58.0,,35.0,6.0,14.0,285.0,2.0,23.0,39.0,2.0,48.0,3.0,2.0,4.0,1.0,13.0,4.0,1.0,,6.0,0.0,1.0,4.0,7.0,3.0,2.0,1.0,,3.0,0.0,0.0,,,2.0,6.0,2.0,1.0,8.0,0.0,4.0,1.0,11.0,0.0,0.0,,3.0,0.0,17.0,0.0,,0.0,27.0,1.0,10.0,0.0,6.0,1.0,1.0,,0.0,0.0,3.0,1.0,5.0,1.0,1.0,17.0,0.0,1.0,5.0,1.0,3.0,12.0,1.0,0.0,2.0,1.0,44.0,1.0,1.0,1.0,14.0,0.0,0.0,31.0,0.0,2.0,,,6.0,,0.0,,,0.0,0.0,1.0,0.0,3.0,2.0,1.0,24.0,0.0,0.0,14.0,3.0,54.0,3.0,1.0,3.0,0.0,,0.0,0.0,2.0,29.0,105.0,,67.0,2.0,0.0,1.0,2.0,0.0,0.0,,3.0,3.0,5.0,3.0,7.0,0.0,,0.0,0.0
2024-07-20 00:00:00+00:00,51.0,,34.0,10.0,12.0,277.0,3.0,27.0,18.0,1.0,42.0,0.0,1.0,7.0,0.0,9.0,9.0,0.0,,1.0,0.0,1.0,4.0,5.0,1.0,1.0,3.0,,10.0,0.0,0.0,,,0.0,1.0,4.0,2.0,8.0,0.0,2.0,1.0,6.0,0.0,1.0,,2.0,0.0,9.0,2.0,,2.0,31.0,1.0,4.0,0.0,2.0,1.0,1.0,,0.0,2.0,0.0,0.0,1.0,0.0,0.0,12.0,0.0,1.0,3.0,0.0,0.0,12.0,0.0,0.0,0.0,1.0,34.0,1.0,0.0,0.0,6.0,0.0,0.0,29.0,0.0,2.0,,,2.0,,0.0,,,1.0,1.0,1.0,1.0,0.0,1.0,1.0,18.0,1.0,0.0,10.0,3.0,50.0,6.0,1.0,0.0,0.0,,4.0,0.0,0.0,25.0,134.0,,71.0,0.0,1.0,0.0,0.0,0.0,0.0,,0.0,0.0,0.0,0.0,5.0,0.0,,0.0,0.0
2024-07-21 00:00:00+00:00,59.0,,28.0,12.0,7.0,286.0,7.0,22.0,48.0,4.0,28.0,0.0,1.0,16.0,1.0,10.0,0.0,1.0,,0.0,0.0,0.0,4.0,8.0,1.0,0.0,0.0,,5.0,0.0,6.0,,,1.0,0.0,1.0,5.0,9.0,0.0,0.0,0.0,13.0,0.0,0.0,,5.0,0.0,14.0,0.0,,1.0,37.0,0.0,10.0,0.0,1.0,0.0,0.0,,1.0,0.0,0.0,1.0,1.0,0.0,1.0,10.0,0.0,0.0,2.0,1.0,2.0,18.0,0.0,0.0,0.0,0.0,35.0,1.0,0.0,1.0,3.0,0.0,0.0,29.0,0.0,2.0,,,6.0,,1.0,,,0.0,0.0,0.0,0.0,1.0,2.0,4.0,20.0,0.0,0.0,13.0,4.0,65.0,3.0,3.0,0.0,0.0,,5.0,0.0,0.0,22.0,122.0,,79.0,0.0,0.0,2.0,0.0,0.0,1.0,,0.0,1.0,1.0,1.0,4.0,0.0,,1.0,0.0
2024-07-22 00:00:00+00:00,84.0,,55.0,3.0,27.0,297.0,10.0,33.0,34.0,2.0,35.0,2.0,4.0,13.0,1.0,18.0,1.0,3.0,,3.0,0.0,2.0,5.0,5.0,0.0,0.0,3.0,,5.0,2.0,2.0,,,3.0,2.0,3.0,12.0,0.0,0.0,18.0,2.0,18.0,0.0,0.0,,5.0,3.0,23.0,1.0,,0.0,44.0,0.0,12.0,1.0,0.0,2.0,0.0,,0.0,0.0,0.0,0.0,1.0,1.0,1.0,23.0,0.0,2.0,0.0,3.0,2.0,14.0,1.0,0.0,3.0,15.0,49.0,3.0,0.0,1.0,17.0,0.0,0.0,45.0,0.0,3.0,,,5.0,,0.0,,,3.0,0.0,1.0,1.0,1.0,2.0,3.0,32.0,1.0,0.0,20.0,8.0,49.0,2.0,11.0,2.0,3.0,,2.0,0.0,0.0,36.0,137.0,,84.0,1.0,0.0,1.0,1.0,1.0,0.0,,1.0,4.0,6.0,2.0,7.0,0.0,,0.0,0.0
2024-07-23 00:00:00+00:00,59.0,,37.0,16.0,7.0,357.0,5.0,33.0,19.0,5.0,47.0,0.0,9.0,4.0,0.0,12.0,7.0,50.0,,0.0,0.0,3.0,6.0,9.0,7.0,1.0,0.0,,3.0,1.0,0.0,,,2.0,0.0,4.0,10.0,11.0,1.0,16.0,2.0,10.0,0.0,0.0,,5.0,1.0,24.0,1.0,,2.0,41.0,11.0,15.0,0.0,1.0,0.0,0.0,,0.0,2.0,0.0,0.0,4.0,0.0,4.0,12.0,0.0,1.0,4.0,50.0,0.0,15.0,0.0,0.0,1.0,3.0,57.0,4.0,0.0,2.0,18.0,0.0,0.0,53.0,1.0,6.0,,,11.0,,2.0,,,3.0,0.0,1.0,0.0,1.0,1.0,3.0,25.0,0.0,0.0,23.0,6.0,67.0,0.0,7.0,0.0,2.0,,1.0,0.0,0.0,51.0,131.0,,99.0,1.0,0.0,3.0,0.0,0.0,1.0,,0.0,1.0,11.0,1.0,1.0,2.0,,0.0,0.0
2024-07-24 00:00:00+00:00,114.0,,52.0,11.0,5.0,323.0,24.0,35.0,34.0,4.0,25.0,0.0,5.0,1.0,0.0,18.0,4.0,20.0,,6.0,0.0,2.0,2.0,15.0,7.0,0.0,3.0,,17.0,0.0,2.0,,,7.0,1.0,5.0,12.0,7.0,0.0,6.0,1.0,13.0,0.0,1.0,,5.0,0.0,19.0,1.0,,4.0,36.0,2.0,8.0,1.0,2.0,0.0,2.0,,0.0,0.0,3.0,3.0,2.0,1.0,0.0,15.0,1.0,0.0,8.0,20.0,5.0,12.0,0.0,2.0,1.0,3.0,46.0,2.0,1.0,3.0,4.0,0.0,0.0,41.0,0.0,3.0,,,11.0,,1.0,,,0.0,5.0,5.0,0.0,3.0,1.0,5.0,39.0,0.0,0.0,28.0,7.0,53.0,1.0,0.0,2.0,0.0,,2.0,1.0,1.0,44.0,148.0,,89.0,1.0,2.0,0.0,0.0,0.0,0.0,,0.0,4.0,2.0,2.0,4.0,0.0,,1.0,0.0
2024-07-25 00:00:00+00:00,165.0,,47.0,12.0,16.0,334.0,15.0,26.0,34.0,3.0,38.0,1.0,3.0,4.0,0.0,14.0,3.0,8.0,,2.0,0.0,12.0,1.0,4.0,4.0,2.0,2.0,,4.0,2.0,3.0,,,5.0,7.0,1.0,6.0,13.0,0.0,2.0,4.0,21.0,0.0,2.0,,3.0,1.0,20.0,1.0,,4.0,36.0,1.0,9.0,0.0,1.0,2.0,0.0,,1.0,0.0,1.0,1.0,5.0,0.0,0.0,6.0,0.0,3.0,6.0,8.0,0.0,15.0,1.0,1.0,2.0,5.0,42.0,0.0,0.0,1.0,4.0,0.0,0.0,45.0,0.0,1.0,,,1.0,,1.0,,,2.0,3.0,0.0,0.0,13.0,1.0,3.0,39.0,3.0,0.0,20.0,7.0,57.0,1.0,1.0,3.0,0.0,,3.0,0.0,1.0,38.0,141.0,,91.0,2.0,0.0,2.0,0.0,0.0,0.0,,0.0,2.0,2.0,3.0,6.0,2.0,,3.0,0.0
2024-07-26 00:00:00+00:00,147.0,,38.0,32.0,11.0,293.0,5.0,35.0,65.0,4.0,30.0,2.0,9.0,18.0,2.0,20.0,2.0,12.0,,6.0,0.0,0.0,6.0,12.0,4.0,1.0,7.0,,13.0,0.0,0.0,,,0.0,8.0,3.0,4.0,3.0,0.0,8.0,2.0,17.0,0.0,3.0,,5.0,2.0,9.0,1.0,,1.0,24.0,2.0,5.0,2.0,1.0,1.0,2.0,,0.0,0.0,3.0,1.0,1.0,4.0,2.0,10.0,0.0,1.0,4.0,12.0,1.0,17.0,0.0,3.0,2.0,4.0,35.0,2.0,0.0,2.0,10.0,0.0,0.0,53.0,0.0,2.0,,,9.0,,0.0,,,0.0,2.0,1.0,0.0,4.0,5.0,2.0,47.0,1.0,1.0,19.0,8.0,48.0,0.0,1.0,2.0,1.0,,1.0,0.0,1.0,45.0,130.0,,95.0,1.0,0.0,1.0,0.0,0.0,0.0,,0.0,0.0,4.0,0.0,9.0,0.0,,0.0,0.0
2024-07-27 00:00:00+00:00,151.0,,38.0,3.0,4.0,282.0,3.0,15.0,18.0,2.0,31.0,1.0,10.0,8.0,0.0,11.0,5.0,6.0,,1.0,0.0,1.0,9.0,4.0,6.0,0.0,2.0,,1.0,1.0,1.0,,,0.0,1.0,0.0,2.0,3.0,0.0,1.0,0.0,12.0,0.0,0.0,,0.0,0.0,16.0,0.0,,3.0,45.0,2.0,11.0,2.0,0.0,0.0,1.0,,0.0,0.0,0.0,0.0,0.0,0.0,3.0,8.0,0.0,0.0,8.0,6.0,0.0,13.0,0.0,0.0,0.0,1.0,32.0,0.0,0.0,0.0,2.0,0.0,0.0,44.0,0.0,2.0,,,10.0,,4.0,,,0.0,3.0,1.0,0.0,2.0,2.0,3.0,42.0,0.0,0.0,10.0,2.0,30.0,2.0,3.0,0.0,0.0,,5.0,1.0,0.0,34.0,89.0,,102.0,3.0,0.0,3.0,0.0,0.0,1.0,,0.0,1.0,4.0,5.0,17.0,0.0,,1.0,0.0
2024-07-28 00:00:00+00:00,136.0,,35.0,13.0,9.0,386.0,6.0,18.0,20.0,1.0,14.0,1.0,4.0,4.0,2.0,14.0,4.0,11.0,,0.0,0.0,2.0,1.0,9.0,5.0,0.0,3.0,,8.0,0.0,0.0,,,0.0,2.0,2.0,2.0,8.0,0.0,4.0,0.0,19.0,0.0,1.0,,7.0,3.0,21.0,1.0,,0.0,42.0,0.0,9.0,0.0,0.0,2.0,1.0,,0.0,0.0,3.0,1.0,7.0,0.0,0.0,13.0,1.0,2.0,5.0,11.0,2.0,12.0,0.0,0.0,1.0,3.0,25.0,2.0,0.0,0.0,1.0,0.0,0.0,34.0,0.0,4.0,,,9.0,,3.0,,,1.0,1.0,0.0,0.0,0.0,0.0,0.0,34.0,1.0,0.0,9.0,2.0,18.0,4.0,2.0,1.0,0.0,,8.0,0.0,0.0,22.0,116.0,,82.0,0.0,0.0,1.0,0.0,0.0,0.0,,0.0,1.0,0.0,0.0,6.0,0.0,,0.0,0.0
2024-07-29 00:00:00+00:00,179.0,,44.0,24.0,28.0,355.0,12.0,31.0,32.0,4.0,44.0,0.0,11.0,1.0,0.0,14.0,2.0,4.0,,6.0,0.0,2.0,0.0,13.0,5.0,2.0,4.0,,15.0,0.0,0.0,,,0.0,1.0,6.0,8.0,8.0,1.0,4.0,0.0,15.0,0.0,0.0,,2.0,1.0,14.0,3.0,,2.0,42.0,7.0,10.0,0.0,2.0,1.0,0.0,,1.0,1.0,3.0,1.0,5.0,1.0,1.0,26.0,0.0,1.0,5.0,4.0,3.0,11.0,0.0,0.0,2.0,1.0,32.0,1.0,0.0,3.0,3.0,0.0,0.0,45.0,0.0,4.0,,,12.0,,4.0,,,1.0,0.0,1.0,1.0,1.0,2.0,3.0,50.0,0.0,1.0,33.0,6.0,80.0,1.0,1.0,0.0,0.0,,5.0,1.0,2.0,18.0,119.0,,109.0,0.0,0.0,0.0,0.0,0.0,1.0,,0.0,3.0,9.0,2.0,14.0,0.0,,0.0,0.0
2024-07-30 00:00:00+00:00,202.0,,52.0,23.0,21.0,336.0,11.0,52.0,38.0,5.0,22.0,1.0,3.0,8.0,0.0,14.0,4.0,9.0,,2.0,0.0,0.0,4.0,28.0,17.0,1.0,10.0,,5.0,0.0,1.0,,,4.0,5.0,1.0,4.0,10.0,0.0,2.0,3.0,19.0,0.0,0.0,,10.0,0.0,19.0,1.0,,0.0,35.0,4.0,10.0,2.0,1.0,4.0,3.0,,2.0,1.0,2.0,0.0,3.0,0.0,2.0,18.0,0.0,2.0,7.0,9.0,1.0,16.0,2.0,0.0,1.0,5.0,46.0,2.0,0.0,0.0,28.0,0.0,0.0,49.0,0.0,2.0,,,11.0,,0.0,,,0.0,1.0,0.0,0.0,2.0,2.0,2.0,26.0,0.0,1.0,24.0,4.0,41.0,4.0,0.0,2.0,1.0,,2.0,1.0,1.0,35.0,115.0,,103.0,0.0,0.0,1.0,0.0,2.0,1.0,,0.0,2.0,10.0,0.0,6.0,0.0,,0.0,0.0
2024-07-31 00:00:00+00:00,172.0,,62.0,28.0,17.0,340.0,3.0,28.0,21.0,7.0,47.0,0.0,2.0,3.0,0.0,12.0,5.0,11.0,,4.0,0.0,1.0,5.0,9.0,5.0,0.0,4.0,,3.0,0.0,1.0,,,1.0,4.0,0.0,4.0,7.0,0.0,7.0,2.0,18.0,1.0,0.0,,14.0,0.0,24.0,1.0,,2.0,41.0,1.0,9.0,1.0,9.0,3.0,2.0,,1.0,0.0,0.0,0.0,0.0,0.0,0.0,22.0,1.0,3.0,3.0,11.0,2.0,22.0,0.0,0.0,2.0,2.0,57.0,3.0,1.0,3.0,6.0,0.0,0.0,56.0,0.0,4.0,,,8.0,,1.0,,,2.0,3.0,0.0,0.0,2.0,0.0,1.0,46.0,0.0,2.0,23.0,8.0,50.0,4.0,10.0,1.0,2.0,,1.0,0.0,2.0,43.0,135.0,,91.0,0.0,0.0,2.0,0.0,0.0,0.0,,0.0,4.0,6.0,3.0,9.0,1.0,,0.0,0.0
2024-08-01 00:00:00+00:00,186.0,,67.0,26.0,11.0,305.0,2.0,20.0,50.0,11.0,66.0,0.0,2.0,6.0,3.0,19.0,11.0,8.0,,2.0,1.0,1.0,8.0,9.0,8.0,0.0,4.0,,7.0,0.0,0.0,,,20.0,1.0,1.0,7.0,4.0,0.0,10.0,0.0,26.0,0.0,3.0,,15.0,1.0,19.0,1.0,,3.0,31.0,3.0,1.0,4.0,5.0,3.0,2.0,,0.0,0.0,0.0,0.0,7.0,1.0,5.0,15.0,2.0,5.0,4.0,8.0,26.0,20.0,1.0,0.0,1.0,5.0,58.0,3.0,0.0,0.0,5.0,0.0,0.0,43.0,0.0,1.0,,,9.0,,0.0,,,6.0,3.0,1.0,1.0,0.0,0.0,3.0,44.0,3.0,1.0,17.0,4.0,71.0,4.0,1.0,0.0,0.0,,3.0,0.0,3.0,45.0,137.0,,94.0,0.0,0.0,0.0,0.0,0.0,1.0,,0.0,5.0,10.0,7.0,9.0,1.0,,0.0,0.0
2024-08-02 00:00:00+00:00,194.0,,39.0,32.0,13.0,356.0,4.0,21.0,62.0,6.0,37.0,3.0,11.0,6.0,0.0,21.0,10.0,7.0,,1.0,0.0,0.0,13.0,11.0,9.0,3.0,4.0,,9.0,0.0,1.0,,,14.0,9.0,1.0,1.0,7.0,1.0,1.0,2.0,14.0,1.0,2.0,,2.0,1.0,17.0,2.0,,2.0,34.0,2.0,14.0,1.0,6.0,5.0,0.0,,1.0,1.0,6.0,6.0,0.0,0.0,1.0,26.0,1.0,3.0,6.0,7.0,25.0,20.0,0.0,1.0,2.0,2.0,36.0,0.0,0.0,2.0,18.0,0.0,0.0,65.0,0.0,5.0,,,13.0,,1.0,,,0.0,2.0,0.0,0.0,1.0,3.0,2.0,33.0,0.0,0.0,18.0,4.0,72.0,0.0,0.0,1.0,0.0,,2.0,0.0,0.0,32.0,149.0,,95.0,0.0,1.0,2.0,0.0,0.0,1.0,,1.0,1.0,6.0,0.0,8.0,0.0,,1.0,0.0
2024-08-03 00:00:00+00:00,173.0,,18.0,10.0,25.0,251.0,3.0,18.0,30.0,2.0,28.0,0.0,2.0,2.0,0.0,14.0,2.0,8.0,,2.0,0.0,3.0,0.0,27.0,3.0,2.0,5.0,,13.0,1.0,3.0,,,3.0,2.0,2.0,4.0,4.0,0.0,9.0,1.0,14.0,1.0,0.0,,7.0,0.0,21.0,3.0,,1.0,20.0,3.0,14.0,2.0,3.0,2.0,1.0,,0.0,0.0,6.0,1.0,3.0,0.0,0.0,27.0,0.0,1.0,6.0,8.0,12.0,7.0,1.0,0.0,2.0,1.0,42.0,0.0,1.0,4.0,8.0,0.0,0.0,96.0,0.0,1.0,,,7.0,,1.0,,,0.0,0.0,5.0,0.0,1.0,1.0,1.0,31.0,0.0,0.0,16.0,1.0,75.0,4.0,2.0,1.0,0.0,,3.0,0.0,1.0,38.0,133.0,,77.0,1.0,0.0,0.0,0.0,0.0,0.0,,0.0,0.0,0.0,1.0,5.0,0.0,,0.0,0.0
2024-08-04 00:00:00+00:00,156.0,,23.0,14.0,23.0,257.0,12.0,25.0,26.0,3.0,21.0,1.0,6.0,0.0,0.0,17.0,5.0,3.0,,1.0,0.0,1.0,2.0,46.0,7.0,0.0,2.0,,24.0,1.0,0.0,,,3.0,12.0,3.0,6.0,5.0,0.0,5.0,0.0,16.0,0.0,0.0,,5.0,0.0,15.0,5.0,,1.0,28.0,0.0,12.0,1.0,0.0,1.0,0.0,,0.0,0.0,1.0,3.0,0.0,1.0,4.0,16.0,0.0,2.0,4.0,3.0,1.0,14.0,1.0,0.0,2.0,1.0,28.0,1.0,0.0,1.0,6.0,0.0,0.0,99.0,0.0,1.0,,,7.0,,2.0,,,3.0,2.0,3.0,0.0,0.0,6.0,0.0,38.0,0.0,2.0,20.0,4.0,38.0,2.0,1.0,0.0,0.0,,2.0,0.0,0.0,26.0,137.0,,97.0,0.0,0.0,7.0,0.0,0.0,0.0,,0.0,2.0,4.0,1.0,3.0,0.0,,0.0,0.0
2024-08-05 00:00:00+00:00,238.0,,40.0,50.0,35.0,353.0,14.0,48.0,28.0,9.0,17.0,2.0,4.0,16.0,0.0,26.0,9.0,9.0,,1.0,0.0,2.0,1.0,15.0,2.0,1.0,5.0,,8.0,2.0,0.0,,,4.0,11.0,5.0,10.0,20.0,0.0,2.0,2.0,30.0,0.0,0.0,,3.0,2.0,22.0,6.0,,1.0,25.0,11.0,15.0,1.0,2.0,3.0,1.0,,0.0,0.0,3.0,1.0,7.0,2.0,3.0,11.0,1.0,1.0,5.0,9.0,6.0,16.0,0.0,2.0,8.0,4.0,56.0,3.0,2.0,1.0,12.0,0.0,0.0,86.0,0.0,3.0,,,12.0,,1.0,,,2.0,6.0,1.0,1.0,6.0,4.0,1.0,43.0,1.0,1.0,24.0,5.0,40.0,3.0,4.0,0.0,1.0,,3.0,0.0,0.0,32.0,210.0,,116.0,0.0,0.0,2.0,0.0,0.0,0.0,,0.0,3.0,8.0,3.0,9.0,0.0,,1.0,0.0
2024-08-06 00:00:00+00:00,193.0,,50.0,33.0,55.0,320.0,2.0,30.0,17.0,1.0,24.0,1.0,9.0,40.0,0.0,22.0,6.0,12.0,,5.0,0.0,0.0,0.0,25.0,6.0,5.0,1.0,,6.0,1.0,1.0,,,2.0,2.0,2.0,3.0,7.0,2.0,1.0,1.0,13.0,0.0,3.0,,2.0,0.0,21.0,2.0,,2.0,36.0,2.0,9.0,3.0,5.0,8.0,1.0,,0.0,0.0,3.0,2.0,4.0,1.0,6.0,24.0,0.0,1.0,2.0,12.0,3.0,12.0,0.0,2.0,0.0,7.0,62.0,0.0,0.0,2.0,6.0,0.0,0.0,72.0,0.0,2.0,,,9.0,,1.0,,,1.0,10.0,0.0,1.0,3.0,1.0,7.0,42.0,0.0,0.0,19.0,10.0,84.0,2.0,2.0,2.0,3.0,,5.0,1.0,1.0,34.0,157.0,,104.0,0.0,0.0,2.0,0.0,0.0,0.0,,0.0,5.0,7.0,4.0,5.0,1.0,,0.0,0.0
2024-08-07 00:00:00+00:00,217.0,,60.0,15.0,25.0,323.0,5.0,39.0,28.0,7.0,35.0,4.0,11.0,10.0,1.0,14.0,5.0,11.0,,0.0,0.0,4.0,10.0,62.0,1.0,2.0,5.0,,9.0,1.0,1.0,,,6.0,10.0,2.0,3.0,2.0,0.0,1.0,2.0,20.0,0.0,2.0,,4.0,4.0,26.0,2.0,,2.0,42.0,1.0,8.0,3.0,4.0,3.0,3.0,,0.0,0.0,0.0,1.0,2.0,0.0,4.0,18.0,0.0,3.0,4.0,11.0,3.0,13.0,1.0,3.0,1.0,3.0,38.0,4.0,4.0,1.0,18.0,1.0,0.0,58.0,0.0,4.0,,,11.0,,0.0,,,2.0,3.0,4.0,0.0,1.0,11.0,4.0,49.0,0.0,0.0,28.0,10.0,31.0,4.0,1.0,3.0,4.0,,8.0,2.0,1.0,39.0,167.0,,103.0,1.0,0.0,3.0,0.0,0.0,0.0,,1.0,4.0,13.0,12.0,9.0,0.0,,1.0,0.0
2024-08-08 00:00:00+00:00,181.0,,67.0,30.0,40.0,310.0,4.0,32.0,32.0,3.0,34.0,4.0,4.0,9.0,2.0,22.0,4.0,11.0,,1.0,0.0,0.0,4.0,16.0,2.0,1.0,1.0,,21.0,1.0,1.0,,,6.0,7.0,6.0,10.0,11.0,0.0,5.0,2.0,19.0,1.0,2.0,,5.0,0.0,25.0,1.0,,4.0,43.0,2.0,8.0,5.0,0.0,3.0,2.0,,0.0,0.0,1.0,1.0,5.0,1.0,1.0,18.0,3.0,2.0,4.0,11.0,4.0,21.0,2.0,0.0,1.0,6.0,46.0,0.0,1.0,1.0,10.0,0.0,0.0,103.0,0.0,2.0,,,11.0,,1.0,,,1.0,2.0,4.0,0.0,2.0,1.0,7.0,65.0,0.0,0.0,12.0,9.0,39.0,2.0,3.0,4.0,2.0,,1.0,8.0,2.0,46.0,155.0,,107.0,0.0,0.0,2.0,0.0,1.0,0.0,,0.0,9.0,10.0,5.0,6.0,1.0,,1.0,0.0
2024-08-09 00:00:00+00:00,194.0,,50.0,16.0,30.0,360.0,2.0,46.0,55.0,6.0,37.0,2.0,15.0,8.0,1.0,20.0,2.0,12.0,,1.0,0.0,1.0,3.0,19.0,3.0,0.0,1.0,,3.0,1.0,1.0,,,7.0,5.0,1.0,9.0,5.0,0.0,16.0,1.0,11.0,1.0,2.0,,5.0,1.0,29.0,1.0,,3.0,53.0,0.0,9.0,4.0,2.0,5.0,2.0,,0.0,1.0,1.0,1.0,3.0,1.0,2.0,21.0,10.0,2.0,3.0,12.0,2.0,16.0,2.0,1.0,0.0,11.0,45.0,2.0,0.0,0.0,12.0,0.0,0.0,77.0,0.0,2.0,,,10.0,,1.0,,,1.0,3.0,2.0,0.0,1.0,3.0,3.0,52.0,0.0,0.0,14.0,6.0,67.0,3.0,0.0,5.0,9.0,,6.0,0.0,2.0,27.0,150.0,,88.0,5.0,0.0,1.0,0.0,0.0,1.0,,0.0,4.0,1.0,0.0,8.0,0.0,,3.0,0.0
2024-08-10 00:00:00+00:00,163.0,,48.0,5.0,15.0,310.0,3.0,28.0,37.0,1.0,21.0,0.0,3.0,13.0,0.0,8.0,6.0,2.0,,2.0,0.0,3.0,2.0,6.0,0.0,1.0,2.0,,1.0,3.0,1.0,,,9.0,2.0,3.0,5.0,11.0,0.0,8.0,0.0,9.0,0.0,0.0,,1.0,0.0,18.0,0.0,,5.0,33.0,0.0,8.0,2.0,2.0,4.0,2.0,,0.0,0.0,0.0,6.0,0.0,0.0,1.0,11.0,1.0,1.0,4.0,2.0,0.0,7.0,0.0,0.0,0.0,0.0,47.0,2.0,1.0,1.0,1.0,0.0,0.0,111.0,0.0,1.0,,,11.0,,0.0,,,0.0,1.0,3.0,0.0,1.0,5.0,1.0,31.0,2.0,0.0,15.0,0.0,52.0,2.0,6.0,0.0,2.0,,9.0,0.0,0.0,26.0,118.0,,80.0,1.0,2.0,1.0,0.0,0.0,2.0,,0.0,0.0,2.0,2.0,4.0,0.0,,1.0,0.0
2024-08-11 00:00:00+00:00,152.0,,39.0,7.0,14.0,274.0,4.0,27.0,26.0,4.0,24.0,1.0,9.0,26.0,2.0,18.0,3.0,4.0,,2.0,0.0,2.0,1.0,8.0,0.0,0.0,5.0,,1.0,12.0,1.0,,,3.0,3.0,1.0,5.0,10.0,0.0,6.0,0.0,9.0,0.0,0.0,,4.0,1.0,14.0,1.0,,1.0,49.0,0.0,7.0,1.0,0.0,4.0,0.0,,0.0,0.0,3.0,0.0,2.0,0.0,1.0,15.0,2.0,0.0,9.0,4.0,1.0,10.0,0.0,0.0,3.0,3.0,57.0,2.0,0.0,0.0,0.0,0.0,0.0,109.0,0.0,3.0,,,8.0,,2.0,,,0.0,5.0,0.0,0.0,1.0,6.0,2.0,32.0,1.0,0.0,6.0,6.0,42.0,1.0,1.0,1.0,0.0,,3.0,0.0,0.0,17.0,118.0,,81.0,0.0,0.0,2.0,0.0,0.0,0.0,,0.0,1.0,0.0,0.0,6.0,0.0,,0.0,0.0
2024-08-12 00:00:00+00:00,193.0,,56.0,19.0,19.0,288.0,7.0,43.0,41.0,6.0,34.0,1.0,10.0,5.0,0.0,18.0,2.0,6.0,,0.0,0.0,3.0,0.0,13.0,9.0,0.0,2.0,,7.0,1.0,1.0,,,5.0,7.0,3.0,8.0,10.0,3.0,5.0,7.0,19.0,0.0,0.0,,0.0,1.0,22.0,0.0,,1.0,47.0,1.0,7.0,0.0,2.0,0.0,0.0,,1.0,0.0,0.0,1.0,4.0,0.0,1.0,9.0,0.0,3.0,3.0,6.0,1.0,8.0,1.0,0.0,3.0,8.0,54.0,2.0,2.0,0.0,17.0,0.0,0.0,89.0,4.0,2.0,,,16.0,,5.0,,,5.0,5.0,4.0,0.0,4.0,2.0,3.0,37.0,1.0,2.0,7.0,5.0,46.0,3.0,0.0,2.0,0.0,,4.0,1.0,1.0,21.0,131.0,,84.0,0.0,0.0,2.0,0.0,1.0,0.0,,0.0,3.0,7.0,2.0,5.0,0.0,,1.0,0.0
2024-08-13 00:00:00+00:00,183.0,,74.0,29.0,24.0,306.0,5.0,67.0,21.0,3.0,36.0,0.0,9.0,20.0,0.0,24.0,11.0,10.0,,4.0,0.0,7.0,3.0,8.0,3.0,2.0,3.0,,14.0,0.0,1.0,,,9.0,4.0,2.0,7.0,13.0,0.0,2.0,1.0,17.0,1.0,4.0,,2.0,1.0,12.0,1.0,,1.0,48.0,2.0,3.0,1.0,2.0,2.0,3.0,,0.0,0.0,1.0,3.0,5.0,2.0,0.0,14.0,0.0,2.0,4.0,10.0,4.0,13.0,0.0,3.0,1.0,3.0,46.0,0.0,1.0,0.0,19.0,0.0,0.0,102.0,0.0,2.0,,,10.0,,2.0,,,2.0,6.0,4.0,0.0,6.0,2.0,5.0,43.0,0.0,0.0,18.0,12.0,70.0,2.0,1.0,1.0,4.0,,2.0,1.0,1.0,23.0,150.0,,91.0,2.0,0.0,0.0,0.0,0.0,0.0,,1.0,5.0,9.0,0.0,10.0,1.0,,1.0,0.0
2024-08-14 00:00:00+00:00,180.0,,64.0,39.0,23.0,294.0,3.0,76.0,24.0,4.0,29.0,1.0,19.0,6.0,2.0,37.0,3.0,34.0,,3.0,0.0,11.0,4.0,46.0,6.0,0.0,3.0,,17.0,0.0,0.0,,,5.0,10.0,1.0,6.0,11.0,0.0,2.0,2.0,18.0,0.0,1.0,,4.0,0.0,19.0,0.0,,4.0,47.0,0.0,11.0,5.0,2.0,4.0,2.0,,0.0,1.0,5.0,2.0,2.0,1.0,0.0,23.0,0.0,1.0,6.0,34.0,2.0,15.0,3.0,0.0,1.0,15.0,51.0,2.0,2.0,3.0,7.0,0.0,0.0,132.0,1.0,1.0,,,6.0,,1.0,,,1.0,2.0,6.0,2.0,3.0,2.0,2.0,37.0,3.0,0.0,21.0,7.0,58.0,1.0,2.0,1.0,1.0,,10.0,0.0,1.0,61.0,163.0,,100.0,1.0,0.0,2.0,0.0,0.0,0.0,,0.0,19.0,8.0,3.0,5.0,0.0,,0.0,0.0
2024-08-15 00:00:00+00:00,175.0,,63.0,49.0,19.0,297.0,3.0,33.0,38.0,2.0,30.0,1.0,7.0,4.0,1.0,24.0,6.0,10.0,,0.0,2.0,4.0,4.0,37.0,1.0,2.0,6.0,,15.0,3.0,1.0,,,2.0,14.0,1.0,3.0,18.0,1.0,1.0,0.0,16.0,2.0,1.0,,10.0,1.0,20.0,2.0,,2.0,77.0,0.0,12.0,4.0,2.0,3.0,1.0,,1.0,0.0,3.0,5.0,3.0,1.0,1.0,17.0,1.0,3.0,4.0,10.0,0.0,11.0,0.0,1.0,4.0,14.0,34.0,3.0,4.0,0.0,8.0,0.0,0.0,77.0,0.0,1.0,,,7.0,,0.0,,,2.0,9.0,3.0,2.0,2.0,0.0,4.0,46.0,1.0,2.0,11.0,9.0,59.0,0.0,1.0,3.0,3.0,,5.0,0.0,1.0,49.0,137.0,,99.0,2.0,0.0,2.0,1.0,0.0,1.0,,0.0,1.0,8.0,5.0,5.0,0.0,,3.0,0.0
2024-08-16 00:00:00+00:00,167.0,,44.0,29.0,20.0,320.0,7.0,35.0,27.0,5.0,33.0,3.0,19.0,18.0,0.0,49.0,2.0,6.0,,1.0,2.0,2.0,3.0,39.0,3.0,1.0,2.0,,10.0,8.0,0.0,,,8.0,4.0,1.0,7.0,10.0,0.0,2.0,6.0,29.0,1.0,2.0,,0.0,1.0,30.0,2.0,,1.0,42.0,1.0,10.0,3.0,0.0,2.0,1.0,,1.0,1.0,3.0,1.0,3.0,2.0,4.0,22.0,3.0,0.0,6.0,6.0,3.0,12.0,0.0,1.0,0.0,41.0,42.0,1.0,6.0,0.0,0.0,2.0,0.0,125.0,0.0,1.0,,,9.0,,0.0,,,0.0,9.0,0.0,2.0,0.0,11.0,4.0,39.0,1.0,0.0,13.0,8.0,31.0,3.0,2.0,4.0,3.0,,3.0,0.0,0.0,53.0,159.0,,83.0,1.0,1.0,1.0,0.0,0.0,0.0,,2.0,3.0,0.0,1.0,10.0,1.0,,2.0,0.0
2024-08-17 00:00:00+00:00,145.0,,30.0,30.0,16.0,288.0,2.0,23.0,22.0,4.0,18.0,0.0,6.0,5.0,0.0,21.0,2.0,11.0,,2.0,0.0,2.0,0.0,47.0,5.0,1.0,3.0,,55.0,4.0,0.0,,,7.0,4.0,0.0,2.0,4.0,0.0,0.0,3.0,11.0,0.0,3.0,,4.0,0.0,12.0,3.0,,1.0,60.0,1.0,11.0,0.0,2.0,1.0,1.0,,0.0,0.0,5.0,0.0,0.0,1.0,0.0,14.0,3.0,3.0,3.0,10.0,2.0,6.0,2.0,0.0,1.0,17.0,26.0,0.0,0.0,0.0,12.0,0.0,0.0,125.0,0.0,2.0,,,5.0,,0.0,,,0.0,2.0,4.0,0.0,1.0,9.0,6.0,32.0,1.0,1.0,6.0,4.0,26.0,1.0,0.0,2.0,0.0,,2.0,0.0,0.0,32.0,121.0,,85.0,0.0,0.0,0.0,0.0,0.0,1.0,,1.0,0.0,1.0,0.0,1.0,0.0,,1.0,0.0
2024-08-18 00:00:00+00:00,125.0,,56.0,24.0,7.0,297.0,4.0,19.0,16.0,6.0,25.0,0.0,6.0,8.0,0.0,36.0,6.0,9.0,,0.0,0.0,0.0,3.0,11.0,2.0,0.0,2.0,,9.0,0.0,0.0,,,3.0,1.0,3.0,7.0,2.0,0.0,8.0,3.0,9.0,0.0,0.0,,2.0,1.0,14.0,3.0,,3.0,49.0,0.0,7.0,1.0,0.0,1.0,4.0,,0.0,0.0,2.0,0.0,1.0,1.0,1.0,11.0,2.0,1.0,0.0,9.0,5.0,8.0,0.0,0.0,7.0,47.0,31.0,2.0,0.0,2.0,9.0,0.0,0.0,139.0,0.0,2.0,,,7.0,,3.0,,,0.0,2.0,1.0,0.0,0.0,0.0,1.0,39.0,0.0,0.0,12.0,7.0,32.0,2.0,0.0,0.0,4.0,,8.0,0.0,0.0,32.0,112.0,,86.0,0.0,0.0,1.0,0.0,0.0,0.0,,0.0,1.0,2.0,0.0,5.0,0.0,,0.0,0.0
2024-08-19 00:00:00+00:00,169.0,,70.0,40.0,18.0,504.0,11.0,26.0,18.0,3.0,28.0,2.0,7.0,10.0,0.0,34.0,10.0,11.0,,0.0,0.0,2.0,8.0,17.0,2.0,1.0,4.0,,14.0,0.0,1.0,,,8.0,6.0,4.0,7.0,5.0,4.0,3.0,3.0,18.0,0.0,1.0,,4.0,1.0,20.0,1.0,,2.0,43.0,1.0,10.0,2.0,4.0,1.0,2.0,,4.0,1.0,2.0,4.0,6.0,1.0,1.0,13.0,1.0,6.0,3.0,11.0,2.0,12.0,2.0,0.0,5.0,11.0,37.0,3.0,0.0,2.0,10.0,0.0,0.0,91.0,0.0,6.0,,,11.0,,1.0,,,7.0,3.0,8.0,3.0,4.0,3.0,4.0,44.0,2.0,0.0,13.0,7.0,41.0,3.0,3.0,6.0,0.0,,3.0,1.0,0.0,49.0,151.0,,79.0,0.0,0.0,0.0,0.0,1.0,0.0,,0.0,4.0,4.0,1.0,5.0,0.0,,1.0,0.0
2024-08-20 00:00:00+00:00,184.0,,65.0,50.0,14.0,409.0,5.0,26.0,46.0,1.0,39.0,2.0,6.0,13.0,0.0,24.0,8.0,7.0,,6.0,3.0,0.0,5.0,15.0,1.0,1.0,7.0,,23.0,3.0,0.0,,,11.0,4.0,2.0,21.0,8.0,1.0,9.0,3.0,7.0,0.0,18.0,,2.0,0.0,35.0,2.0,,1.0,28.0,2.0,12.0,7.0,0.0,2.0,0.0,,9.0,8.0,2.0,1.0,2.0,0.0,0.0,24.0,6.0,3.0,6.0,6.0,2.0,17.0,1.0,1.0,0.0,6.0,71.0,6.0,2.0,6.0,9.0,0.0,0.0,70.0,0.0,6.0,,,12.0,,15.0,,,3.0,4.0,10.0,0.0,2.0,6.0,3.0,42.0,0.0,0.0,24.0,11.0,56.0,5.0,3.0,5.0,3.0,,6.0,24.0,0.0,32.0,146.0,,88.0,3.0,0.0,1.0,0.0,3.0,0.0,,1.0,3.0,6.0,2.0,4.0,0.0,,2.0,0.0
2024-08-21 00:00:00+00:00,231.0,,77.0,127.0,31.0,345.0,9.0,46.0,34.0,2.0,28.0,1.0,7.0,8.0,0.0,23.0,10.0,3.0,,5.0,3.0,1.0,2.0,12.0,3.0,0.0,3.0,,10.0,1.0,0.0,,,5.0,5.0,0.0,3.0,7.0,1.0,7.0,2.0,19.0,1.0,6.0,,3.0,0.0,22.0,3.0,,0.0,31.0,0.0,11.0,1.0,3.0,2.0,1.0,,13.0,0.0,4.0,2.0,2.0,0.0,3.0,18.0,1.0,3.0,14.0,3.0,4.0,19.0,1.0,0.0,4.0,10.0,51.0,4.0,2.0,0.0,13.0,0.0,0.0,127.0,0.0,4.0,,,5.0,,4.0,,,0.0,5.0,0.0,1.0,3.0,5.0,3.0,47.0,1.0,1.0,12.0,10.0,56.0,1.0,2.0,1.0,0.0,,4.0,3.0,0.0,27.0,205.0,,107.0,0.0,0.0,3.0,0.0,0.0,0.0,,0.0,8.0,10.0,2.0,7.0,0.0,,4.0,0.0
2024-08-22 00:00:00+00:00,219.0,,79.0,59.0,34.0,350.0,1.0,37.0,33.0,2.0,29.0,1.0,5.0,2.0,1.0,22.0,14.0,11.0,,5.0,6.0,2.0,3.0,16.0,6.0,0.0,2.0,,13.0,0.0,2.0,,,4.0,4.0,3.0,6.0,10.0,0.0,4.0,4.0,13.0,0.0,3.0,,3.0,1.0,19.0,3.0,,3.0,54.0,1.0,8.0,0.0,0.0,7.0,0.0,,6.0,0.0,3.0,0.0,8.0,0.0,3.0,20.0,1.0,3.0,9.0,11.0,2.0,14.0,0.0,1.0,4.0,2.0,37.0,3.0,2.0,0.0,4.0,0.0,0.0,115.0,0.0,3.0,,,20.0,,21.0,,,3.0,4.0,3.0,2.0,3.0,2.0,5.0,46.0,0.0,2.0,25.0,10.0,45.0,3.0,2.0,11.0,2.0,,3.0,0.0,1.0,41.0,183.0,,72.0,0.0,0.0,1.0,0.0,0.0,2.0,,1.0,4.0,7.0,0.0,4.0,1.0,,6.0,0.0
2024-08-23 00:00:00+00:00,198.0,,65.0,82.0,17.0,301.0,7.0,47.0,52.0,9.0,26.0,1.0,4.0,26.0,0.0,30.0,7.0,6.0,,6.0,8.0,5.0,4.0,5.0,0.0,0.0,5.0,,0.0,2.0,4.0,,,3.0,5.0,2.0,8.0,10.0,2.0,3.0,4.0,19.0,0.0,6.0,,12.0,0.0,35.0,14.0,,6.0,52.0,1.0,10.0,1.0,31.0,3.0,8.0,,5.0,1.0,4.0,0.0,2.0,1.0,5.0,26.0,3.0,3.0,9.0,6.0,2.0,11.0,0.0,3.0,1.0,4.0,46.0,0.0,3.0,0.0,33.0,0.0,0.0,136.0,0.0,5.0,,,14.0,,27.0,,,0.0,8.0,10.0,3.0,2.0,5.0,0.0,35.0,0.0,2.0,16.0,13.0,46.0,3.0,1.0,5.0,5.0,,6.0,2.0,0.0,17.0,149.0,,81.0,0.0,0.0,2.0,0.0,0.0,0.0,,2.0,3.0,6.0,3.0,6.0,0.0,,5.0,0.0
2024-08-24 00:00:00+00:00,228.0,,56.0,18.0,14.0,301.0,2.0,29.0,27.0,1.0,24.0,0.0,4.0,10.0,0.0,24.0,3.0,5.0,,0.0,7.0,1.0,3.0,16.0,0.0,0.0,5.0,,9.0,5.0,2.0,,,3.0,2.0,2.0,4.0,5.0,1.0,1.0,2.0,24.0,0.0,5.0,,0.0,0.0,26.0,4.0,,6.0,42.0,1.0,5.0,1.0,6.0,4.0,14.0,,0.0,0.0,6.0,1.0,1.0,2.0,3.0,31.0,1.0,4.0,4.0,5.0,1.0,9.0,0.0,2.0,3.0,2.0,48.0,3.0,0.0,1.0,11.0,0.0,0.0,110.0,0.0,1.0,,,2.0,,5.0,,,0.0,4.0,3.0,0.0,3.0,6.0,4.0,44.0,0.0,4.0,10.0,3.0,37.0,7.0,1.0,0.0,3.0,,1.0,2.0,0.0,38.0,114.0,,107.0,0.0,0.0,3.0,0.0,0.0,0.0,,0.0,2.0,2.0,0.0,6.0,0.0,,0.0,0.0
2024-08-25 00:00:00+00:00,180.0,,38.0,33.0,15.0,319.0,1.0,19.0,29.0,9.0,22.0,0.0,7.0,5.0,1.0,14.0,9.0,5.0,,4.0,1.0,2.0,0.0,17.0,2.0,1.0,1.0,,19.0,0.0,4.0,,,1.0,0.0,1.0,11.0,4.0,0.0,2.0,3.0,15.0,0.0,4.0,,5.0,0.0,32.0,4.0,,2.0,37.0,0.0,14.0,3.0,0.0,0.0,4.0,,0.0,0.0,0.0,0.0,1.0,1.0,2.0,16.0,1.0,3.0,3.0,5.0,0.0,13.0,0.0,2.0,1.0,4.0,46.0,1.0,0.0,0.0,25.0,0.0,0.0,91.0,0.0,2.0,,,8.0,,2.0,,,0.0,11.0,7.0,0.0,0.0,2.0,3.0,37.0,0.0,1.0,5.0,2.0,29.0,3.0,1.0,4.0,2.0,,9.0,0.0,0.0,19.0,118.0,,99.0,0.0,1.0,0.0,0.0,1.0,0.0,,0.0,0.0,1.0,0.0,3.0,0.0,,0.0,0.0
2024-08-26 00:00:00+00:00,223.0,,59.0,29.0,20.0,310.0,5.0,34.0,22.0,4.0,18.0,2.0,9.0,5.0,0.0,21.0,5.0,10.0,,3.0,3.0,3.0,1.0,4.0,2.0,0.0,7.0,,2.0,0.0,1.0,,,5.0,3.0,2.0,16.0,2.0,1.0,2.0,5.0,28.0,0.0,1.0,,1.0,1.0,9.0,2.0,,2.0,42.0,1.0,6.0,0.0,2.0,2.0,5.0,,0.0,1.0,0.0,1.0,2.0,0.0,3.0,22.0,0.0,1.0,3.0,10.0,0.0,10.0,0.0,0.0,1.0,13.0,43.0,0.0,3.0,0.0,15.0,0.0,0.0,115.0,0.0,0.0,,,6.0,,5.0,,,0.0,13.0,11.0,1.0,1.0,2.0,4.0,45.0,2.0,2.0,3.0,6.0,47.0,0.0,2.0,5.0,1.0,,0.0,0.0,2.0,37.0,129.0,,71.0,0.0,0.0,2.0,1.0,0.0,0.0,,0.0,2.0,3.0,1.0,3.0,0.0,,2.0,0.0
2024-08-27 00:00:00+00:00,210.0,,72.0,55.0,31.0,324.0,5.0,141.0,39.0,2.0,30.0,2.0,8.0,9.0,1.0,24.0,3.0,8.0,,2.0,1.0,3.0,1.0,22.0,4.0,0.0,3.0,,1.0,17.0,1.0,,,4.0,3.0,1.0,6.0,5.0,3.0,5.0,2.0,17.0,0.0,4.0,,2.0,6.0,25.0,5.0,,1.0,26.0,2.0,9.0,1.0,4.0,0.0,3.0,,0.0,2.0,5.0,4.0,1.0,2.0,1.0,16.0,1.0,3.0,5.0,8.0,3.0,13.0,0.0,0.0,1.0,54.0,51.0,6.0,5.0,3.0,5.0,0.0,0.0,110.0,0.0,3.0,,,28.0,,4.0,,,2.0,8.0,5.0,3.0,2.0,1.0,8.0,47.0,0.0,0.0,11.0,9.0,44.0,2.0,2.0,5.0,2.0,,2.0,0.0,0.0,36.0,172.0,,88.0,1.0,0.0,1.0,2.0,0.0,0.0,,1.0,2.0,4.0,1.0,7.0,0.0,,0.0,0.0
2024-08-28 00:00:00+00:00,229.0,,54.0,51.0,23.0,325.0,7.0,74.0,27.0,6.0,21.0,1.0,9.0,8.0,1.0,24.0,9.0,4.0,,2.0,0.0,0.0,6.0,16.0,3.0,2.0,5.0,,9.0,4.0,3.0,,,4.0,7.0,1.0,8.0,6.0,1.0,2.0,3.0,15.0,0.0,3.0,,5.0,0.0,29.0,5.0,,1.0,45.0,0.0,13.0,1.0,1.0,2.0,2.0,,3.0,1.0,2.0,1.0,7.0,3.0,5.0,16.0,3.0,3.0,3.0,4.0,2.0,13.0,2.0,0.0,2.0,52.0,53.0,2.0,6.0,1.0,14.0,1.0,0.0,134.0,0.0,2.0,,,6.0,,3.0,,,2.0,4.0,4.0,4.0,2.0,3.0,2.0,41.0,3.0,4.0,17.0,11.0,49.0,4.0,1.0,6.0,0.0,,6.0,0.0,1.0,41.0,165.0,,109.0,1.0,0.0,0.0,0.0,0.0,0.0,,0.0,3.0,28.0,5.0,4.0,0.0,,3.0,0.0
2024-08-29 00:00:00+00:00,195.0,,72.0,18.0,23.0,332.0,10.0,40.0,11.0,8.0,27.0,1.0,17.0,11.0,0.0,27.0,4.0,8.0,,4.0,0.0,3.0,0.0,12.0,4.0,0.0,4.0,,12.0,0.0,1.0,,,5.0,2.0,2.0,7.0,3.0,0.0,4.0,6.0,19.0,1.0,3.0,,3.0,0.0,21.0,0.0,,5.0,232.0,1.0,11.0,0.0,17.0,4.0,3.0,,0.0,0.0,1.0,11.0,15.0,1.0,5.0,22.0,0.0,0.0,4.0,8.0,1.0,9.0,7.0,0.0,1.0,59.0,30.0,0.0,1.0,0.0,10.0,0.0,0.0,126.0,0.0,3.0,,,9.0,,3.0,,,0.0,10.0,1.0,18.0,2.0,2.0,11.0,59.0,0.0,0.0,19.0,9.0,40.0,1.0,1.0,2.0,4.0,,5.0,0.0,2.0,46.0,136.0,,110.0,0.0,0.0,0.0,0.0,6.0,0.0,,1.0,5.0,16.0,0.0,9.0,0.0,,3.0,0.0
2024-08-30 00:00:00+00:00,207.0,,66.0,24.0,14.0,282.0,12.0,40.0,32.0,5.0,30.0,0.0,6.0,11.0,0.0,28.0,11.0,4.0,,12.0,6.0,4.0,5.0,35.0,6.0,1.0,2.0,,14.0,4.0,0.0,,,3.0,4.0,1.0,10.0,4.0,0.0,1.0,1.0,12.0,0.0,1.0,,1.0,1.0,28.0,5.0,,0.0,91.0,1.0,9.0,2.0,3.0,11.0,0.0,,0.0,1.0,1.0,3.0,11.0,0.0,3.0,20.0,4.0,6.0,6.0,4.0,0.0,13.0,0.0,0.0,4.0,12.0,36.0,2.0,2.0,2.0,11.0,0.0,0.0,110.0,0.0,1.0,,,12.0,,0.0,,,1.0,3.0,9.0,14.0,2.0,3.0,8.0,63.0,0.0,0.0,11.0,10.0,27.0,1.0,1.0,3.0,5.0,,1.0,0.0,0.0,34.0,179.0,,86.0,3.0,0.0,0.0,0.0,3.0,1.0,,0.0,2.0,5.0,4.0,3.0,1.0,,3.0,0.0
2024-08-31 00:00:00+00:00,147.0,,70.0,49.0,16.0,263.0,2.0,17.0,19.0,5.0,14.0,0.0,5.0,2.0,0.0,15.0,7.0,3.0,,2.0,5.0,5.0,1.0,6.0,0.0,0.0,1.0,,4.0,0.0,0.0,,,29.0,1.0,0.0,5.0,9.0,0.0,9.0,3.0,12.0,0.0,1.0,,2.0,1.0,25.0,2.0,,2.0,74.0,4.0,8.0,3.0,1.0,5.0,1.0,,0.0,0.0,1.0,1.0,14.0,3.0,3.0,16.0,1.0,0.0,8.0,3.0,0.0,9.0,0.0,0.0,5.0,5.0,36.0,3.0,0.0,1.0,4.0,0.0,0.0,72.0,0.0,2.0,,,7.0,,0.0,,,0.0,6.0,5.0,4.0,1.0,1.0,2.0,32.0,1.0,0.0,6.0,5.0,27.0,0.0,0.0,0.0,6.0,,9.0,0.0,0.0,15.0,138.0,,74.0,0.0,0.0,0.0,0.0,0.0,0.0,,0.0,2.0,0.0,2.0,2.0,0.0,,1.0,0.0
2024-09-01 00:00:00+00:00,143.0,,55.0,19.0,15.0,238.0,2.0,20.0,23.0,7.0,31.0,0.0,2.0,4.0,1.0,13.0,3.0,7.0,,3.0,2.0,2.0,2.0,7.0,1.0,0.0,3.0,,2.0,0.0,1.0,,,4.0,1.0,1.0,6.0,2.0,0.0,9.0,3.0,9.0,0.0,0.0,,3.0,0.0,11.0,3.0,,0.0,39.0,2.0,12.0,3.0,0.0,5.0,2.0,,1.0,0.0,0.0,3.0,7.0,2.0,6.0,10.0,2.0,0.0,6.0,6.0,0.0,9.0,1.0,2.0,1.0,26.0,43.0,4.0,0.0,2.0,2.0,0.0,0.0,98.0,0.0,3.0,,,6.0,,1.0,,,0.0,6.0,10.0,1.0,0.0,1.0,1.0,32.0,0.0,0.0,10.0,17.0,34.0,1.0,0.0,2.0,4.0,,3.0,0.0,0.0,11.0,118.0,,67.0,0.0,1.0,1.0,0.0,0.0,0.0,,0.0,2.0,0.0,0.0,3.0,0.0,,0.0,0.0
2024-09-02 00:00:00+00:00,258.0,,52.0,18.0,11.0,287.0,1.0,22.0,23.0,5.0,30.0,1.0,3.0,9.0,1.0,18.0,8.0,12.0,,1.0,3.0,2.0,7.0,6.0,5.0,0.0,4.0,,2.0,0.0,1.0,,,8.0,0.0,0.0,5.0,4.0,1.0,11.0,5.0,10.0,0.0,2.0,,1.0,1.0,17.0,0.0,,1.0,94.0,1.0,13.0,3.0,6.0,3.0,3.0,,0.0,1.0,3.0,4.0,8.0,1.0,5.0,19.0,3.0,0.0,3.0,12.0,3.0,10.0,3.0,3.0,8.0,4.0,41.0,5.0,4.0,0.0,17.0,0.0,0.0,108.0,0.0,2.0,,,3.0,,1.0,,,0.0,3.0,7.0,1.0,1.0,3.0,4.0,43.0,0.0,1.0,9.0,12.0,64.0,4.0,0.0,2.0,4.0,,2.0,0.0,2.0,26.0,152.0,,75.0,1.0,0.0,0.0,0.0,0.0,0.0,,0.0,1.0,0.0,0.0,5.0,0.0,,3.0,0.0
2024-09-03 00:00:00+00:00,208.0,,71.0,95.0,14.0,340.0,3.0,30.0,52.0,3.0,20.0,1.0,9.0,7.0,0.0,22.0,2.0,6.0,,3.0,1.0,3.0,4.0,6.0,0.0,2.0,4.0,,1.0,0.0,4.0,,,9.0,2.0,3.0,12.0,6.0,0.0,16.0,5.0,14.0,0.0,8.0,,1.0,0.0,22.0,1.0,,1.0,59.0,0.0,10.0,6.0,3.0,2.0,3.0,,0.0,0.0,0.0,2.0,5.0,3.0,0.0,13.0,3.0,1.0,8.0,6.0,2.0,5.0,0.0,3.0,1.0,2.0,37.0,1.0,1.0,2.0,4.0,0.0,0.0,116.0,0.0,6.0,,,10.0,,0.0,,,1.0,3.0,1.0,1.0,1.0,4.0,2.0,30.0,1.0,0.0,15.0,10.0,48.0,2.0,1.0,1.0,2.0,,7.0,0.0,0.0,31.0,150.0,,95.0,1.0,0.0,0.0,0.0,0.0,0.0,,1.0,2.0,2.0,1.0,2.0,0.0,,1.0,1.0
2024-09-04 00:00:00+00:00,220.0,,161.0,76.0,14.0,332.0,2.0,39.0,59.0,2.0,22.0,0.0,3.0,36.0,1.0,29.0,3.0,9.0,,2.0,0.0,1.0,42.0,10.0,0.0,0.0,1.0,,11.0,3.0,1.0,,,7.0,1.0,0.0,14.0,14.0,0.0,7.0,5.0,15.0,0.0,6.0,,0.0,0.0,25.0,1.0,,2.0,79.0,0.0,6.0,2.0,0.0,4.0,7.0,,0.0,1.0,3.0,11.0,4.0,5.0,1.0,19.0,3.0,3.0,10.0,9.0,0.0,9.0,1.0,0.0,4.0,3.0,74.0,4.0,3.0,6.0,8.0,0.0,0.0,88.0,0.0,3.0,,,10.0,,0.0,,,0.0,3.0,3.0,3.0,1.0,4.0,2.0,55.0,5.0,0.0,15.0,20.0,79.0,3.0,2.0,1.0,1.0,,1.0,0.0,0.0,35.0,196.0,,95.0,2.0,0.0,2.0,0.0,0.0,0.0,,0.0,2.0,6.0,3.0,13.0,0.0,,7.0,0.0
2024-09-05 00:00:00+00:00,195.0,,100.0,88.0,14.0,333.0,4.0,25.0,44.0,5.0,21.0,3.0,2.0,4.0,0.0,25.0,3.0,4.0,,5.0,0.0,0.0,23.0,6.0,1.0,3.0,2.0,,1.0,0.0,0.0,,,10.0,3.0,0.0,14.0,17.0,0.0,7.0,2.0,24.0,0.0,1.0,,5.0,1.0,18.0,0.0,,2.0,86.0,0.0,12.0,1.0,3.0,1.0,2.0,,1.0,0.0,5.0,6.0,8.0,1.0,2.0,18.0,0.0,4.0,1.0,4.0,3.0,4.0,0.0,5.0,2.0,2.0,37.0,0.0,0.0,1.0,8.0,0.0,0.0,134.0,0.0,2.0,,,12.0,,2.0,,,2.0,5.0,4.0,8.0,4.0,2.0,2.0,35.0,1.0,2.0,22.0,9.0,88.0,6.0,1.0,2.0,6.0,,3.0,0.0,1.0,38.0,155.0,,107.0,0.0,0.0,3.0,0.0,0.0,0.0,,1.0,1.0,8.0,1.0,6.0,0.0,,5.0,0.0
2024-09-06 00:00:00+00:00,162.0,,123.0,35.0,16.0,285.0,5.0,22.0,24.0,7.0,12.0,0.0,1.0,7.0,3.0,38.0,2.0,8.0,,2.0,1.0,0.0,13.0,2.0,1.0,0.0,5.0,,1.0,4.0,0.0,,,5.0,5.0,1.0,12.0,7.0,0.0,10.0,4.0,19.0,0.0,6.0,,0.0,1.0,33.0,3.0,,3.0,51.0,0.0,11.0,0.0,2.0,7.0,3.0,,1.0,1.0,1.0,2.0,1.0,2.0,2.0,21.0,2.0,0.0,6.0,8.0,2.0,7.0,1.0,2.0,2.0,23.0,58.0,2.0,1.0,1.0,65.0,0.0,0.0,154.0,0.0,2.0,,,13.0,,1.0,,,0.0,4.0,5.0,2.0,2.0,2.0,2.0,50.0,2.0,0.0,20.0,10.0,91.0,3.0,2.0,1.0,4.0,,6.0,0.0,0.0,28.0,197.0,,104.0,0.0,1.0,1.0,0.0,0.0,1.0,,0.0,1.0,3.0,0.0,9.0,0.0,,0.0,0.0
2024-09-07 00:00:00+00:00,182.0,,73.0,20.0,9.0,265.0,2.0,13.0,15.0,7.0,30.0,0.0,2.0,6.0,1.0,11.0,2.0,5.0,,0.0,0.0,0.0,5.0,7.0,5.0,0.0,7.0,,1.0,2.0,1.0,,,8.0,3.0,1.0,4.0,8.0,0.0,0.0,3.0,19.0,0.0,0.0,,2.0,0.0,14.0,1.0,,4.0,61.0,0.0,7.0,1.0,0.0,2.0,4.0,,0.0,0.0,0.0,0.0,4.0,1.0,0.0,9.0,2.0,0.0,4.0,5.0,1.0,6.0,0.0,1.0,2.0,0.0,84.0,2.0,2.0,7.0,17.0,0.0,0.0,98.0,0.0,5.0,,,12.0,,4.0,,,0.0,1.0,3.0,0.0,0.0,3.0,1.0,35.0,1.0,3.0,9.0,2.0,59.0,1.0,1.0,3.0,8.0,,3.0,0.0,0.0,38.0,130.0,,69.0,0.0,0.0,0.0,0.0,0.0,0.0,,0.0,1.0,3.0,0.0,3.0,0.0,,2.0,0.0
2024-09-08 00:00:00+00:00,154.0,,54.0,14.0,26.0,264.0,5.0,20.0,27.0,5.0,15.0,0.0,4.0,13.0,0.0,20.0,3.0,2.0,,0.0,0.0,2.0,6.0,7.0,0.0,0.0,11.0,,2.0,0.0,1.0,,,4.0,2.0,0.0,6.0,6.0,1.0,5.0,2.0,7.0,0.0,0.0,,3.0,0.0,17.0,0.0,,1.0,92.0,0.0,9.0,1.0,2.0,0.0,0.0,,2.0,0.0,1.0,0.0,5.0,0.0,0.0,6.0,0.0,3.0,5.0,2.0,2.0,13.0,1.0,0.0,4.0,3.0,49.0,1.0,0.0,4.0,31.0,0.0,0.0,91.0,0.0,2.0,,,11.0,,2.0,,,3.0,1.0,3.0,2.0,2.0,1.0,1.0,45.0,2.0,4.0,12.0,3.0,36.0,3.0,0.0,0.0,12.0,,8.0,0.0,0.0,32.0,114.0,,74.0,0.0,0.0,2.0,0.0,0.0,1.0,,0.0,0.0,2.0,0.0,10.0,1.0,,0.0,0.0
2024-09-09 00:00:00+00:00,176.0,,57.0,33.0,21.0,311.0,7.0,28.0,33.0,6.0,25.0,1.0,6.0,12.0,1.0,25.0,4.0,6.0,,3.0,0.0,0.0,5.0,7.0,0.0,5.0,9.0,,0.0,0.0,1.0,,,6.0,2.0,1.0,13.0,7.0,2.0,1.0,8.0,14.0,0.0,3.0,,21.0,2.0,11.0,3.0,,0.0,85.0,1.0,17.0,1.0,1.0,2.0,6.0,,1.0,0.0,1.0,7.0,7.0,0.0,1.0,15.0,0.0,0.0,1.0,6.0,2.0,16.0,4.0,1.0,2.0,1.0,63.0,0.0,3.0,0.0,21.0,0.0,0.0,69.0,0.0,5.0,,,13.0,,1.0,,,1.0,3.0,5.0,1.0,4.0,1.0,1.0,41.0,0.0,1.0,21.0,4.0,65.0,2.0,1.0,3.0,5.0,,6.0,0.0,0.0,30.0,158.0,,86.0,1.0,0.0,0.0,0.0,0.0,0.0,,0.0,1.0,2.0,1.0,1.0,0.0,,3.0,0.0
2024-09-10 00:00:00+00:00,172.0,,77.0,53.0,19.0,295.0,7.0,23.0,43.0,9.0,35.0,0.0,3.0,4.0,2.0,23.0,2.0,15.0,,2.0,1.0,1.0,2.0,2.0,6.0,2.0,5.0,,1.0,1.0,0.0,,,5.0,1.0,0.0,24.0,4.0,3.0,3.0,7.0,17.0,1.0,6.0,,19.0,0.0,22.0,1.0,,3.0,135.0,1.0,6.0,0.0,1.0,5.0,5.0,,0.0,1.0,0.0,4.0,8.0,0.0,1.0,61.0,2.0,0.0,7.0,15.0,9.0,8.0,0.0,1.0,2.0,3.0,66.0,1.0,1.0,2.0,8.0,0.0,0.0,92.0,0.0,2.0,,,10.0,,2.0,,,0.0,3.0,8.0,3.0,6.0,5.0,9.0,48.0,0.0,0.0,24.0,5.0,62.0,1.0,0.0,0.0,4.0,,4.0,0.0,2.0,29.0,136.0,,86.0,2.0,0.0,0.0,0.0,0.0,0.0,,1.0,2.0,17.0,0.0,6.0,0.0,,2.0,0.0
2024-09-11 00:00:00+00:00,147.0,,67.0,87.0,10.0,269.0,5.0,30.0,30.0,4.0,15.0,0.0,8.0,5.0,1.0,16.0,5.0,5.0,,1.0,0.0,2.0,3.0,6.0,6.0,1.0,4.0,,6.0,0.0,0.0,,,12.0,3.0,1.0,15.0,6.0,1.0,6.0,3.0,14.0,0.0,2.0,,7.0,0.0,20.0,5.0,,12.0,98.0,1.0,8.0,2.0,2.0,4.0,3.0,,0.0,0.0,0.0,1.0,4.0,0.0,3.0,54.0,0.0,1.0,2.0,5.0,2.0,15.0,0.0,1.0,0.0,1.0,59.0,5.0,3.0,0.0,7.0,0.0,0.0,93.0,0.0,2.0,,,6.0,,0.0,,,4.0,2.0,3.0,0.0,2.0,3.0,4.0,43.0,0.0,5.0,16.0,14.0,57.0,4.0,0.0,2.0,4.0,,4.0,0.0,1.0,40.0,155.0,,95.0,1.0,0.0,0.0,0.0,0.0,0.0,,0.0,4.0,2.0,0.0,6.0,0.0,,0.0,0.0
2024-09-12 00:00:00+00:00,199.0,,82.0,45.0,13.0,341.0,9.0,29.0,26.0,4.0,27.0,1.0,5.0,17.0,0.0,22.0,4.0,8.0,,0.0,0.0,4.0,3.0,19.0,7.0,0.0,4.0,,6.0,0.0,0.0,,,5.0,0.0,1.0,19.0,11.0,1.0,5.0,2.0,17.0,4.0,6.0,,3.0,1.0,17.0,4.0,,12.0,57.0,2.0,6.0,0.0,3.0,4.0,2.0,,2.0,0.0,2.0,3.0,2.0,2.0,8.0,23.0,0.0,0.0,3.0,8.0,0.0,12.0,1.0,8.0,1.0,1.0,63.0,2.0,2.0,2.0,5.0,0.0,0.0,117.0,0.0,4.0,,,13.0,,1.0,,,1.0,8.0,5.0,4.0,1.0,3.0,7.0,45.0,1.0,0.0,28.0,6.0,46.0,1.0,0.0,1.0,5.0,,4.0,4.0,0.0,26.0,155.0,,89.0,0.0,0.0,0.0,0.0,1.0,0.0,,0.0,1.0,8.0,2.0,6.0,0.0,,3.0,0.0
2024-09-13 00:00:00+00:00,209.0,,50.0,70.0,23.0,274.0,6.0,32.0,20.0,4.0,34.0,1.0,3.0,14.0,1.0,21.0,8.0,2.0,,2.0,1.0,2.0,3.0,13.0,3.0,3.0,3.0,,5.0,0.0,1.0,,,6.0,0.0,0.0,9.0,5.0,0.0,6.0,8.0,13.0,3.0,1.0,,2.0,3.0,15.0,4.0,,4.0,52.0,0.0,8.0,2.0,9.0,2.0,10.0,,0.0,1.0,3.0,1.0,6.0,0.0,1.0,20.0,4.0,1.0,3.0,2.0,4.0,13.0,0.0,5.0,0.0,0.0,93.0,3.0,1.0,0.0,6.0,0.0,0.0,68.0,0.0,3.0,,,12.0,,2.0,,,6.0,2.0,4.0,0.0,3.0,5.0,2.0,44.0,2.0,2.0,10.0,3.0,77.0,2.0,0.0,2.0,3.0,,3.0,0.0,0.0,33.0,143.0,,87.0,0.0,0.0,1.0,0.0,0.0,0.0,,0.0,2.0,5.0,1.0,10.0,0.0,,1.0,0.0
2024-09-14 00:00:00+00:00,175.0,,45.0,28.0,12.0,287.0,1.0,35.0,31.0,2.0,39.0,0.0,5.0,4.0,0.0,14.0,19.0,1.0,,1.0,0.0,3.0,2.0,4.0,3.0,0.0,5.0,,0.0,1.0,0.0,,,5.0,0.0,1.0,3.0,11.0,1.0,1.0,4.0,5.0,0.0,0.0,,0.0,0.0,13.0,3.0,,13.0,35.0,0.0,5.0,0.0,3.0,2.0,2.0,,0.0,3.0,1.0,2.0,2.0,0.0,2.0,19.0,0.0,1.0,3.0,1.0,3.0,11.0,2.0,3.0,2.0,1.0,28.0,0.0,0.0,3.0,6.0,0.0,0.0,60.0,1.0,1.0,,,8.0,,1.0,,,1.0,3.0,2.0,1.0,2.0,4.0,0.0,45.0,1.0,0.0,9.0,2.0,36.0,1.0,0.0,0.0,3.0,,3.0,0.0,0.0,28.0,126.0,,67.0,0.0,0.0,0.0,0.0,1.0,0.0,,0.0,0.0,3.0,0.0,1.0,0.0,,0.0,0.0
2024-09-15 00:00:00+00:00,163.0,,43.0,22.0,6.0,260.0,6.0,23.0,23.0,3.0,27.0,0.0,2.0,2.0,0.0,12.0,11.0,3.0,,2.0,0.0,0.0,0.0,2.0,1.0,0.0,3.0,,1.0,2.0,0.0,,,9.0,0.0,2.0,6.0,6.0,1.0,3.0,3.0,15.0,1.0,1.0,,6.0,0.0,17.0,0.0,,1.0,28.0,0.0,12.0,0.0,2.0,3.0,1.0,,3.0,2.0,2.0,2.0,0.0,2.0,2.0,9.0,1.0,0.0,0.0,3.0,3.0,12.0,0.0,3.0,0.0,1.0,26.0,2.0,3.0,0.0,0.0,0.0,0.0,80.0,0.0,1.0,,,4.0,,4.0,,,0.0,1.0,3.0,0.0,0.0,4.0,0.0,46.0,1.0,0.0,4.0,2.0,24.0,1.0,1.0,1.0,2.0,,7.0,0.0,0.0,26.0,113.0,,65.0,1.0,0.0,0.0,0.0,1.0,0.0,,0.0,1.0,1.0,0.0,2.0,1.0,,2.0,0.0
2024-09-16 00:00:00+00:00,200.0,,36.0,47.0,20.0,276.0,2.0,29.0,33.0,2.0,20.0,1.0,9.0,7.0,8.0,15.0,7.0,4.0,,1.0,0.0,7.0,7.0,0.0,4.0,0.0,3.0,,3.0,0.0,0.0,,,1.0,4.0,2.0,6.0,10.0,1.0,5.0,12.0,12.0,0.0,4.0,,6.0,0.0,17.0,3.0,,3.0,54.0,0.0,12.0,0.0,8.0,6.0,2.0,,1.0,0.0,1.0,4.0,3.0,2.0,7.0,31.0,1.0,1.0,2.0,4.0,1.0,5.0,1.0,3.0,1.0,2.0,64.0,1.0,3.0,1.0,7.0,0.0,0.0,64.0,0.0,2.0,,,5.0,,3.0,,,3.0,0.0,2.0,1.0,1.0,2.0,1.0,39.0,0.0,0.0,18.0,11.0,43.0,2.0,3.0,0.0,1.0,,3.0,0.0,0.0,29.0,146.0,,78.0,1.0,1.0,6.0,0.0,1.0,0.0,,0.0,1.0,3.0,2.0,4.0,1.0,,2.0,0.0
2024-09-17 00:00:00+00:00,220.0,,57.0,31.0,9.0,312.0,6.0,27.0,38.0,3.0,30.0,0.0,6.0,5.0,0.0,19.0,6.0,22.0,,0.0,0.0,1.0,6.0,14.0,5.0,0.0,5.0,,6.0,1.0,0.0,,,8.0,1.0,2.0,9.0,3.0,0.0,1.0,7.0,9.0,0.0,3.0,,4.0,0.0,20.0,1.0,,5.0,71.0,0.0,7.0,3.0,7.0,9.0,2.0,,1.0,0.0,1.0,1.0,0.0,3.0,2.0,16.0,1.0,0.0,4.0,22.0,4.0,7.0,0.0,5.0,1.0,2.0,46.0,1.0,0.0,1.0,0.0,0.0,0.0,111.0,0.0,2.0,,,9.0,,1.0,,,1.0,6.0,0.0,0.0,2.0,2.0,5.0,47.0,0.0,1.0,16.0,6.0,56.0,4.0,0.0,0.0,2.0,,0.0,0.0,1.0,37.0,152.0,,84.0,2.0,0.0,2.0,0.0,2.0,1.0,,1.0,1.0,2.0,0.0,4.0,0.0,,2.0,0.0
2024-09-18 00:00:00+00:00,192.0,,62.0,45.0,5.0,280.0,25.0,48.0,25.0,5.0,27.0,1.0,5.0,12.0,0.0,15.0,6.0,5.0,,2.0,0.0,8.0,31.0,3.0,1.0,1.0,2.0,,1.0,4.0,0.0,,,17.0,6.0,1.0,11.0,12.0,1.0,3.0,6.0,14.0,1.0,3.0,,3.0,0.0,16.0,4.0,,5.0,52.0,1.0,14.0,1.0,4.0,0.0,4.0,,0.0,1.0,1.0,2.0,4.0,0.0,6.0,14.0,2.0,3.0,2.0,5.0,3.0,10.0,0.0,1.0,2.0,2.0,36.0,4.0,1.0,2.0,12.0,0.0,0.0,103.0,0.0,2.0,,,12.0,,0.0,,,2.0,4.0,1.0,0.0,2.0,7.0,5.0,44.0,2.0,3.0,13.0,2.0,52.0,3.0,1.0,1.0,2.0,,3.0,0.0,0.0,46.0,163.0,,97.0,0.0,0.0,2.0,0.0,0.0,0.0,,0.0,3.0,1.0,5.0,4.0,0.0,,5.0,0.0
2024-09-19 00:00:00+00:00,169.0,,46.0,43.0,10.0,288.0,8.0,15.0,34.0,1.0,26.0,0.0,2.0,6.0,0.0,16.0,13.0,9.0,,3.0,0.0,5.0,16.0,14.0,2.0,0.0,5.0,,10.0,3.0,14.0,,,13.0,6.0,1.0,8.0,10.0,0.0,8.0,5.0,16.0,0.0,4.0,,1.0,0.0,21.0,1.0,,0.0,68.0,0.0,8.0,1.0,7.0,0.0,3.0,,0.0,20.0,0.0,2.0,3.0,2.0,4.0,18.0,1.0,2.0,1.0,9.0,2.0,11.0,1.0,1.0,0.0,4.0,58.0,0.0,1.0,7.0,6.0,0.0,0.0,70.0,0.0,5.0,,,12.0,,1.0,,,0.0,6.0,2.0,1.0,0.0,6.0,8.0,47.0,2.0,2.0,14.0,6.0,61.0,2.0,4.0,5.0,2.0,,2.0,1.0,1.0,37.0,166.0,,101.0,0.0,1.0,13.0,0.0,1.0,1.0,,1.0,2.0,8.0,1.0,10.0,0.0,,3.0,0.0
2024-09-20 00:00:00+00:00,189.0,,49.0,33.0,22.0,270.0,4.0,57.0,22.0,5.0,26.0,3.0,11.0,15.0,0.0,18.0,6.0,5.0,,1.0,2.0,3.0,18.0,5.0,0.0,3.0,2.0,,5.0,0.0,5.0,,,11.0,0.0,4.0,4.0,14.0,5.0,1.0,8.0,17.0,2.0,2.0,,3.0,1.0,20.0,1.0,,0.0,53.0,0.0,16.0,0.0,0.0,5.0,3.0,,0.0,21.0,2.0,3.0,2.0,2.0,2.0,15.0,2.0,16.0,3.0,5.0,1.0,11.0,1.0,3.0,2.0,3.0,86.0,0.0,1.0,5.0,4.0,0.0,0.0,53.0,0.0,0.0,,,13.0,,3.0,,,1.0,1.0,15.0,1.0,0.0,1.0,15.0,47.0,0.0,0.0,18.0,9.0,56.0,2.0,1.0,1.0,2.0,,3.0,0.0,0.0,28.0,154.0,,69.0,0.0,0.0,3.0,0.0,1.0,0.0,,0.0,5.0,1.0,3.0,13.0,0.0,,1.0,0.0
2024-09-21 00:00:00+00:00,168.0,,46.0,18.0,6.0,240.0,5.0,21.0,18.0,3.0,23.0,0.0,18.0,18.0,1.0,11.0,5.0,7.0,,2.0,0.0,1.0,3.0,2.0,1.0,1.0,3.0,,3.0,0.0,0.0,,,3.0,2.0,2.0,2.0,9.0,7.0,2.0,2.0,19.0,0.0,0.0,,1.0,0.0,19.0,0.0,,1.0,39.0,0.0,6.0,0.0,0.0,3.0,3.0,,0.0,2.0,0.0,1.0,8.0,2.0,3.0,17.0,0.0,8.0,3.0,7.0,0.0,8.0,0.0,0.0,6.0,5.0,40.0,1.0,0.0,17.0,7.0,0.0,0.0,46.0,0.0,1.0,,,9.0,,1.0,,,0.0,0.0,0.0,2.0,1.0,1.0,2.0,43.0,1.0,0.0,16.0,2.0,49.0,7.0,1.0,4.0,3.0,,3.0,0.0,0.0,20.0,136.0,,95.0,1.0,0.0,2.0,0.0,0.0,1.0,,0.0,2.0,1.0,2.0,8.0,1.0,,0.0,0.0
2024-09-22 00:00:00+00:00,159.0,,65.0,42.0,7.0,232.0,10.0,28.0,23.0,3.0,20.0,0.0,6.0,43.0,0.0,7.0,3.0,4.0,,0.0,1.0,2.0,2.0,4.0,1.0,1.0,4.0,,4.0,1.0,1.0,,,5.0,2.0,0.0,6.0,4.0,0.0,4.0,1.0,15.0,1.0,0.0,,7.0,0.0,13.0,1.0,,0.0,34.0,0.0,15.0,2.0,1.0,4.0,1.0,,0.0,3.0,1.0,3.0,3.0,2.0,1.0,10.0,0.0,2.0,1.0,4.0,0.0,9.0,0.0,3.0,0.0,0.0,42.0,2.0,0.0,7.0,2.0,0.0,0.0,64.0,0.0,0.0,,,11.0,,0.0,,,0.0,0.0,5.0,0.0,2.0,0.0,7.0,31.0,2.0,0.0,6.0,3.0,35.0,0.0,4.0,0.0,1.0,,13.0,1.0,0.0,28.0,130.0,,87.0,0.0,0.0,1.0,0.0,1.0,0.0,,0.0,3.0,2.0,0.0,5.0,0.0,,1.0,0.0
2024-09-23 00:00:00+00:00,154.0,,37.0,69.0,15.0,287.0,6.0,21.0,45.0,4.0,36.0,1.0,8.0,34.0,0.0,16.0,14.0,12.0,,1.0,0.0,0.0,3.0,7.0,2.0,1.0,3.0,,2.0,1.0,2.0,,,6.0,6.0,1.0,8.0,11.0,8.0,3.0,4.0,18.0,3.0,1.0,,4.0,1.0,19.0,5.0,,2.0,99.0,2.0,11.0,1.0,10.0,4.0,0.0,,3.0,2.0,2.0,1.0,2.0,3.0,3.0,15.0,0.0,5.0,3.0,12.0,1.0,8.0,0.0,6.0,2.0,7.0,60.0,4.0,1.0,6.0,7.0,0.0,0.0,84.0,0.0,1.0,,,6.0,,1.0,,,2.0,0.0,16.0,1.0,2.0,4.0,4.0,43.0,0.0,1.0,15.0,11.0,44.0,0.0,4.0,0.0,2.0,,2.0,2.0,0.0,38.0,130.0,,71.0,1.0,1.0,1.0,0.0,0.0,0.0,,0.0,1.0,1.0,2.0,8.0,0.0,,1.0,0.0
2024-09-24 00:00:00+00:00,210.0,,52.0,49.0,12.0,264.0,9.0,26.0,29.0,11.0,34.0,1.0,10.0,17.0,1.0,13.0,9.0,8.0,,3.0,1.0,2.0,12.0,7.0,8.0,1.0,7.0,,4.0,3.0,1.0,,,8.0,1.0,2.0,3.0,21.0,1.0,4.0,3.0,16.0,1.0,4.0,,5.0,0.0,22.0,5.0,,0.0,56.0,3.0,8.0,1.0,5.0,2.0,0.0,,0.0,16.0,4.0,3.0,3.0,2.0,5.0,25.0,0.0,4.0,6.0,8.0,1.0,8.0,1.0,8.0,1.0,4.0,39.0,3.0,3.0,1.0,12.0,0.0,0.0,73.0,0.0,4.0,,,22.0,,4.0,,,1.0,2.0,3.0,0.0,1.0,3.0,1.0,51.0,3.0,3.0,19.0,12.0,42.0,1.0,1.0,5.0,4.0,,0.0,9.0,1.0,49.0,139.0,,104.0,0.0,0.0,2.0,0.0,0.0,0.0,,0.0,2.0,1.0,0.0,9.0,0.0,,0.0,0.0
2024-09-25 00:00:00+00:00,178.0,,59.0,23.0,22.0,280.0,7.0,35.0,47.0,6.0,46.0,1.0,10.0,6.0,2.0,29.0,15.0,5.0,,3.0,0.0,3.0,1.0,7.0,2.0,2.0,5.0,,8.0,0.0,2.0,,,3.0,6.0,0.0,3.0,29.0,6.0,6.0,4.0,14.0,0.0,1.0,,2.0,1.0,16.0,0.0,,0.0,44.0,1.0,7.0,0.0,1.0,1.0,0.0,,0.0,7.0,1.0,2.0,2.0,1.0,4.0,29.0,0.0,3.0,7.0,5.0,2.0,11.0,0.0,7.0,0.0,7.0,42.0,2.0,2.0,10.0,6.0,0.0,0.0,58.0,0.0,0.0,,,9.0,,1.0,,,1.0,2.0,2.0,0.0,4.0,12.0,3.0,46.0,0.0,1.0,6.0,9.0,43.0,4.0,1.0,1.0,2.0,,4.0,3.0,2.0,42.0,157.0,,98.0,1.0,0.0,0.0,0.0,0.0,1.0,,0.0,1.0,1.0,5.0,5.0,0.0,,2.0,0.0
2024-09-26 00:00:00+00:00,180.0,,73.0,17.0,10.0,342.0,66.0,36.0,40.0,3.0,27.0,2.0,10.0,10.0,0.0,26.0,9.0,13.0,,1.0,0.0,4.0,1.0,16.0,2.0,1.0,3.0,,5.0,0.0,11.0,,,8.0,23.0,3.0,10.0,8.0,1.0,2.0,3.0,23.0,1.0,6.0,,22.0,0.0,11.0,2.0,,2.0,71.0,2.0,4.0,0.0,1.0,6.0,1.0,,2.0,5.0,1.0,4.0,5.0,2.0,4.0,11.0,0.0,1.0,4.0,13.0,2.0,13.0,0.0,4.0,1.0,2.0,73.0,2.0,1.0,1.0,3.0,0.0,0.0,88.0,0.0,0.0,,,11.0,,2.0,,,3.0,1.0,2.0,1.0,2.0,8.0,6.0,57.0,1.0,1.0,13.0,19.0,48.0,4.0,1.0,4.0,2.0,,2.0,1.0,0.0,47.0,150.0,,101.0,0.0,2.0,0.0,0.0,1.0,0.0,,0.0,1.0,6.0,4.0,8.0,0.0,,4.0,0.0
2024-09-27 00:00:00+00:00,187.0,,102.0,16.0,14.0,294.0,21.0,38.0,21.0,3.0,10.0,4.0,3.0,17.0,4.0,30.0,13.0,12.0,,1.0,0.0,1.0,3.0,8.0,8.0,0.0,4.0,,2.0,1.0,1.0,,,3.0,2.0,3.0,10.0,10.0,2.0,0.0,4.0,9.0,2.0,5.0,,3.0,0.0,26.0,1.0,,2.0,64.0,0.0,6.0,0.0,1.0,1.0,0.0,,0.0,2.0,0.0,4.0,2.0,2.0,6.0,18.0,2.0,3.0,5.0,12.0,3.0,15.0,0.0,1.0,2.0,2.0,54.0,4.0,2.0,1.0,14.0,0.0,0.0,86.0,0.0,2.0,,,11.0,,0.0,,,1.0,0.0,2.0,0.0,2.0,8.0,3.0,51.0,0.0,0.0,15.0,13.0,49.0,0.0,1.0,3.0,2.0,,1.0,21.0,2.0,46.0,150.0,,85.0,1.0,0.0,2.0,0.0,0.0,1.0,,0.0,2.0,1.0,2.0,3.0,0.0,,3.0,0.0
2024-09-28 00:00:00+00:00,166.0,,60.0,35.0,11.0,300.0,10.0,32.0,18.0,2.0,14.0,1.0,2.0,4.0,1.0,20.0,5.0,8.0,,0.0,0.0,3.0,0.0,25.0,4.0,0.0,0.0,,14.0,0.0,0.0,,,4.0,3.0,0.0,17.0,3.0,1.0,6.0,1.0,10.0,1.0,3.0,,0.0,0.0,13.0,3.0,,5.0,27.0,3.0,8.0,1.0,5.0,3.0,2.0,,0.0,4.0,0.0,0.0,1.0,1.0,8.0,16.0,0.0,1.0,3.0,8.0,6.0,10.0,0.0,2.0,1.0,2.0,40.0,5.0,1.0,0.0,53.0,0.0,0.0,76.0,0.0,1.0,,,15.0,,1.0,,,2.0,2.0,0.0,1.0,0.0,9.0,1.0,29.0,0.0,0.0,11.0,4.0,53.0,1.0,2.0,0.0,3.0,,1.0,16.0,0.0,30.0,102.0,,88.0,0.0,0.0,2.0,0.0,0.0,1.0,,0.0,0.0,1.0,1.0,4.0,0.0,,0.0,0.0
2024-09-29 00:00:00+00:00,140.0,,55.0,17.0,11.0,255.0,6.0,29.0,25.0,5.0,11.0,3.0,2.0,4.0,0.0,29.0,3.0,8.0,,0.0,0.0,3.0,2.0,2.0,1.0,1.0,4.0,,3.0,0.0,1.0,,,6.0,0.0,1.0,11.0,12.0,5.0,4.0,3.0,10.0,0.0,2.0,,3.0,0.0,12.0,0.0,,0.0,25.0,0.0,7.0,0.0,2.0,1.0,2.0,,0.0,1.0,0.0,0.0,0.0,3.0,0.0,21.0,0.0,1.0,5.0,8.0,1.0,14.0,0.0,1.0,1.0,4.0,43.0,3.0,0.0,4.0,32.0,0.0,0.0,69.0,0.0,3.0,,,10.0,,0.0,,,0.0,5.0,2.0,2.0,2.0,4.0,1.0,49.0,0.0,1.0,11.0,2.0,40.0,4.0,2.0,1.0,0.0,,3.0,6.0,0.0,29.0,120.0,,70.0,0.0,0.0,0.0,0.0,0.0,0.0,,0.0,2.0,1.0,7.0,4.0,0.0,,0.0,0.0
2024-09-30 00:00:00+00:00,195.0,,45.0,7.0,6.0,252.0,37.0,26.0,49.0,2.0,18.0,2.0,11.0,15.0,0.0,18.0,4.0,18.0,,3.0,0.0,1.0,4.0,5.0,5.0,0.0,2.0,,3.0,2.0,0.0,,,10.0,3.0,1.0,7.0,11.0,7.0,6.0,6.0,16.0,0.0,2.0,,20.0,0.0,20.0,2.0,,0.0,54.0,1.0,17.0,2.0,0.0,3.0,1.0,,3.0,3.0,0.0,4.0,6.0,6.0,3.0,74.0,0.0,0.0,4.0,17.0,2.0,4.0,1.0,0.0,1.0,3.0,84.0,0.0,1.0,1.0,34.0,0.0,0.0,87.0,0.0,3.0,,,8.0,,1.0,,,0.0,2.0,8.0,1.0,5.0,4.0,1.0,35.0,0.0,2.0,12.0,3.0,53.0,3.0,1.0,3.0,5.0,,2.0,3.0,0.0,42.0,124.0,,109.0,0.0,0.0,0.0,0.0,0.0,1.0,,0.0,1.0,3.0,14.0,5.0,1.0,,2.0,0.0
2024-10-01 00:00:00+00:00,198.0,,73.0,19.0,14.0,328.0,23.0,20.0,52.0,3.0,29.0,2.0,8.0,4.0,1.0,12.0,40.0,8.0,,0.0,0.0,2.0,5.0,9.0,5.0,2.0,4.0,,8.0,1.0,0.0,,,3.0,2.0,2.0,17.0,7.0,3.0,10.0,5.0,20.0,2.0,2.0,,7.0,0.0,19.0,4.0,,1.0,79.0,0.0,10.0,6.0,1.0,6.0,1.0,,2.0,0.0,3.0,2.0,3.0,5.0,2.0,45.0,3.0,8.0,4.0,8.0,1.0,12.0,2.0,1.0,0.0,4.0,223.0,2.0,1.0,1.0,15.0,0.0,0.0,84.0,0.0,3.0,,,7.0,,1.0,,,1.0,1.0,2.0,3.0,2.0,3.0,4.0,36.0,1.0,0.0,9.0,11.0,51.0,2.0,2.0,0.0,2.0,,6.0,1.0,0.0,37.0,130.0,,82.0,0.0,0.0,1.0,0.0,0.0,1.0,,1.0,0.0,4.0,15.0,1.0,1.0,,3.0,0.0
2024-10-02 00:00:00+00:00,179.0,,63.0,24.0,5.0,258.0,17.0,30.0,37.0,7.0,21.0,2.0,8.0,3.0,0.0,19.0,16.0,7.0,,2.0,1.0,0.0,4.0,27.0,6.0,1.0,4.0,,5.0,0.0,2.0,,,5.0,20.0,2.0,14.0,5.0,1.0,4.0,7.0,12.0,0.0,2.0,,3.0,0.0,26.0,0.0,,0.0,36.0,1.0,9.0,5.0,6.0,7.0,1.0,,0.0,2.0,0.0,1.0,0.0,0.0,5.0,42.0,1.0,2.0,5.0,7.0,0.0,15.0,0.0,3.0,1.0,3.0,95.0,6.0,5.0,1.0,6.0,0.0,0.0,70.0,0.0,2.0,,,9.0,,0.0,,,1.0,3.0,0.0,0.0,1.0,4.0,2.0,44.0,0.0,2.0,12.0,12.0,45.0,2.0,2.0,4.0,2.0,,2.0,0.0,2.0,20.0,141.0,,93.0,1.0,0.0,4.0,0.0,0.0,0.0,,0.0,2.0,2.0,0.0,4.0,0.0,,7.0,0.0
2024-10-03 00:00:00+00:00,227.0,,51.0,67.0,11.0,282.0,12.0,22.0,15.0,8.0,34.0,1.0,5.0,17.0,1.0,22.0,11.0,4.0,,1.0,0.0,2.0,2.0,12.0,3.0,0.0,1.0,,4.0,1.0,1.0,,,3.0,2.0,0.0,4.0,7.0,3.0,2.0,6.0,10.0,1.0,3.0,,6.0,0.0,10.0,1.0,,1.0,33.0,1.0,12.0,3.0,2.0,10.0,2.0,,0.0,1.0,2.0,2.0,5.0,0.0,5.0,33.0,0.0,4.0,7.0,4.0,0.0,19.0,0.0,3.0,2.0,7.0,111.0,5.0,2.0,0.0,10.0,0.0,0.0,92.0,0.0,1.0,,,5.0,,1.0,,,0.0,0.0,0.0,0.0,0.0,6.0,5.0,39.0,2.0,1.0,19.0,8.0,53.0,2.0,1.0,0.0,2.0,,2.0,0.0,0.0,57.0,149.0,,120.0,1.0,0.0,0.0,0.0,2.0,0.0,,2.0,1.0,1.0,5.0,8.0,1.0,,3.0,0.0
2024-10-04 00:00:00+00:00,228.0,,74.0,54.0,5.0,291.0,17.0,28.0,30.0,3.0,28.0,0.0,20.0,6.0,0.0,21.0,5.0,8.0,,1.0,0.0,1.0,4.0,2.0,2.0,0.0,2.0,,0.0,1.0,2.0,,,3.0,5.0,0.0,8.0,6.0,6.0,0.0,8.0,9.0,1.0,2.0,,18.0,0.0,21.0,1.0,,1.0,30.0,0.0,10.0,1.0,2.0,2.0,1.0,,1.0,0.0,2.0,1.0,4.0,3.0,5.0,38.0,3.0,0.0,2.0,8.0,3.0,17.0,0.0,1.0,2.0,3.0,107.0,4.0,2.0,2.0,2.0,0.0,0.0,93.0,0.0,3.0,,,6.0,,0.0,,,0.0,1.0,2.0,0.0,1.0,1.0,4.0,46.0,3.0,2.0,9.0,4.0,72.0,3.0,0.0,2.0,3.0,,4.0,0.0,4.0,30.0,170.0,,75.0,1.0,1.0,1.0,0.0,0.0,0.0,,0.0,2.0,2.0,3.0,11.0,0.0,,0.0,0.0
2024-10-05 00:00:00+00:00,152.0,,50.0,44.0,6.0,243.0,5.0,14.0,24.0,3.0,22.0,0.0,9.0,0.0,1.0,15.0,3.0,2.0,,0.0,0.0,0.0,1.0,10.0,0.0,0.0,0.0,,4.0,0.0,1.0,,,1.0,1.0,1.0,2.0,5.0,3.0,1.0,3.0,10.0,0.0,2.0,,4.0,0.0,14.0,10.0,,1.0,22.0,1.0,4.0,1.0,1.0,2.0,7.0,,0.0,2.0,2.0,2.0,2.0,1.0,4.0,34.0,0.0,0.0,7.0,2.0,0.0,10.0,0.0,0.0,2.0,9.0,46.0,0.0,1.0,1.0,8.0,0.0,0.0,91.0,0.0,3.0,,,6.0,,1.0,,,0.0,0.0,2.0,0.0,0.0,0.0,0.0,30.0,0.0,0.0,3.0,11.0,55.0,0.0,5.0,3.0,2.0,,1.0,0.0,0.0,37.0,182.0,,76.0,0.0,2.0,0.0,0.0,0.0,0.0,,0.0,0.0,1.0,0.0,2.0,0.0,,1.0,0.0
2024-10-06 00:00:00+00:00,148.0,,46.0,19.0,3.0,246.0,4.0,28.0,26.0,1.0,20.0,1.0,5.0,0.0,3.0,12.0,3.0,5.0,,0.0,0.0,0.0,0.0,2.0,2.0,0.0,2.0,,2.0,0.0,2.0,,,1.0,1.0,3.0,4.0,10.0,2.0,0.0,3.0,16.0,1.0,2.0,,6.0,0.0,9.0,5.0,,0.0,31.0,0.0,9.0,0.0,3.0,1.0,1.0,,0.0,1.0,3.0,4.0,1.0,1.0,1.0,33.0,1.0,0.0,4.0,5.0,0.0,11.0,1.0,2.0,1.0,2.0,37.0,0.0,1.0,0.0,8.0,0.0,0.0,74.0,0.0,3.0,,,15.0,,0.0,,,0.0,0.0,2.0,0.0,1.0,0.0,1.0,29.0,0.0,0.0,7.0,3.0,49.0,2.0,2.0,0.0,2.0,,6.0,1.0,0.0,33.0,167.0,,60.0,0.0,0.0,0.0,0.0,0.0,0.0,,2.0,1.0,0.0,0.0,9.0,0.0,,0.0,0.0
2024-10-07 00:00:00+00:00,143.0,,63.0,18.0,13.0,269.0,11.0,28.0,23.0,2.0,36.0,4.0,8.0,1.0,0.0,26.0,9.0,11.0,,1.0,0.0,1.0,6.0,7.0,12.0,0.0,9.0,,4.0,0.0,1.0,,,5.0,1.0,0.0,4.0,8.0,2.0,6.0,3.0,12.0,1.0,4.0,,14.0,1.0,19.0,3.0,,1.0,47.0,1.0,5.0,7.0,1.0,5.0,2.0,,2.0,1.0,2.0,2.0,1.0,1.0,0.0,28.0,0.0,0.0,6.0,11.0,2.0,8.0,0.0,0.0,1.0,5.0,52.0,0.0,1.0,2.0,4.0,0.0,0.0,68.0,1.0,2.0,,,9.0,,1.0,,,3.0,0.0,2.0,1.0,1.0,5.0,4.0,44.0,0.0,1.0,14.0,7.0,50.0,2.0,2.0,3.0,0.0,,14.0,0.0,0.0,32.0,190.0,,79.0,1.0,0.0,1.0,0.0,1.0,0.0,,1.0,1.0,1.0,6.0,7.0,0.0,,6.0,0.0
2024-10-08 00:00:00+00:00,116.0,,59.0,35.0,8.0,266.0,8.0,27.0,41.0,6.0,35.0,4.0,8.0,9.0,1.0,35.0,5.0,6.0,,0.0,0.0,2.0,3.0,10.0,7.0,0.0,9.0,,2.0,0.0,0.0,,,9.0,0.0,1.0,4.0,8.0,2.0,3.0,5.0,23.0,1.0,9.0,,8.0,1.0,26.0,0.0,,1.0,236.0,0.0,6.0,3.0,0.0,1.0,0.0,,1.0,0.0,1.0,3.0,4.0,1.0,0.0,24.0,0.0,0.0,8.0,6.0,1.0,15.0,0.0,1.0,10.0,1.0,39.0,4.0,2.0,0.0,8.0,0.0,0.0,74.0,1.0,4.0,,,15.0,,3.0,,,1.0,1.0,3.0,1.0,0.0,4.0,4.0,39.0,1.0,2.0,16.0,12.0,48.0,5.0,5.0,2.0,6.0,,4.0,0.0,0.0,31.0,183.0,,83.0,0.0,0.0,0.0,1.0,0.0,1.0,,2.0,3.0,1.0,2.0,8.0,1.0,,3.0,0.0
2024-10-09 00:00:00+00:00,117.0,,77.0,26.0,4.0,304.0,29.0,35.0,18.0,8.0,20.0,0.0,3.0,7.0,3.0,24.0,2.0,11.0,,0.0,0.0,4.0,5.0,6.0,1.0,1.0,2.0,,1.0,0.0,1.0,,,6.0,1.0,0.0,9.0,7.0,6.0,1.0,5.0,17.0,0.0,9.0,,3.0,3.0,14.0,1.0,,1.0,61.0,1.0,6.0,1.0,1.0,3.0,2.0,,0.0,0.0,4.0,1.0,6.0,1.0,1.0,32.0,1.0,2.0,3.0,11.0,4.0,10.0,1.0,2.0,5.0,2.0,50.0,2.0,1.0,0.0,12.0,0.0,0.0,84.0,0.0,0.0,,,11.0,,3.0,,,3.0,1.0,2.0,0.0,0.0,1.0,5.0,37.0,0.0,7.0,12.0,6.0,48.0,1.0,3.0,2.0,0.0,,3.0,0.0,1.0,27.0,179.0,,102.0,1.0,1.0,1.0,0.0,2.0,0.0,,0.0,1.0,7.0,5.0,7.0,0.0,,4.0,0.0
2024-10-10 00:00:00+00:00,76.0,,297.0,52.0,11.0,267.0,50.0,28.0,15.0,6.0,32.0,1.0,4.0,6.0,2.0,23.0,7.0,10.0,,1.0,1.0,1.0,3.0,7.0,1.0,1.0,4.0,,2.0,1.0,0.0,,,4.0,3.0,3.0,13.0,6.0,2.0,3.0,1.0,13.0,2.0,6.0,,2.0,0.0,13.0,0.0,,0.0,42.0,0.0,3.0,2.0,0.0,3.0,3.0,,2.0,1.0,4.0,0.0,4.0,2.0,0.0,39.0,0.0,1.0,4.0,10.0,0.0,10.0,0.0,0.0,4.0,2.0,44.0,0.0,2.0,0.0,12.0,0.0,0.0,97.0,0.0,3.0,,,13.0,,1.0,,,2.0,0.0,4.0,0.0,4.0,0.0,2.0,45.0,0.0,0.0,7.0,4.0,81.0,2.0,1.0,7.0,2.0,,3.0,2.0,1.0,28.0,165.0,,97.0,0.0,2.0,3.0,0.0,1.0,0.0,,1.0,4.0,7.0,10.0,7.0,1.0,,1.0,0.0
2024-10-11 00:00:00+00:00,97.0,,213.0,21.0,8.0,319.0,120.0,32.0,33.0,2.0,24.0,2.0,8.0,2.0,2.0,29.0,5.0,7.0,,5.0,0.0,4.0,2.0,12.0,2.0,0.0,7.0,,9.0,2.0,0.0,,,2.0,5.0,0.0,4.0,7.0,4.0,15.0,7.0,15.0,0.0,5.0,,2.0,1.0,15.0,1.0,,2.0,36.0,0.0,4.0,1.0,0.0,2.0,1.0,,0.0,3.0,0.0,0.0,4.0,2.0,0.0,23.0,2.0,2.0,9.0,7.0,0.0,15.0,0.0,1.0,3.0,4.0,43.0,1.0,1.0,1.0,17.0,0.0,0.0,55.0,0.0,1.0,,,10.0,,0.0,,,2.0,1.0,2.0,1.0,0.0,3.0,2.0,32.0,1.0,1.0,9.0,8.0,70.0,1.0,4.0,1.0,0.0,,0.0,1.0,0.0,25.0,176.0,,80.0,0.0,1.0,1.0,1.0,0.0,0.0,,1.0,2.0,3.0,3.0,2.0,0.0,,1.0,0.0
2024-10-12 00:00:00+00:00,79.0,,76.0,26.0,15.0,257.0,47.0,27.0,26.0,4.0,28.0,3.0,4.0,10.0,0.0,23.0,5.0,4.0,,1.0,0.0,1.0,0.0,7.0,2.0,0.0,3.0,,3.0,2.0,0.0,,,3.0,0.0,0.0,4.0,7.0,8.0,15.0,1.0,15.0,0.0,0.0,,1.0,0.0,20.0,2.0,,3.0,25.0,4.0,6.0,0.0,2.0,2.0,0.0,,1.0,0.0,1.0,0.0,0.0,0.0,0.0,23.0,0.0,0.0,12.0,4.0,0.0,7.0,0.0,0.0,0.0,85.0,58.0,0.0,2.0,0.0,18.0,0.0,0.0,68.0,0.0,2.0,,,5.0,,0.0,,,0.0,1.0,3.0,1.0,0.0,3.0,3.0,35.0,0.0,1.0,8.0,3.0,35.0,0.0,2.0,4.0,1.0,,3.0,0.0,1.0,27.0,118.0,,94.0,0.0,1.0,2.0,0.0,0.0,2.0,,0.0,0.0,0.0,4.0,5.0,0.0,,2.0,0.0
2024-10-13 00:00:00+00:00,66.0,,56.0,21.0,10.0,243.0,14.0,19.0,17.0,5.0,20.0,1.0,4.0,5.0,1.0,25.0,2.0,5.0,,0.0,1.0,4.0,1.0,17.0,3.0,0.0,2.0,,3.0,3.0,0.0,,,6.0,0.0,1.0,2.0,9.0,3.0,10.0,0.0,17.0,0.0,1.0,,1.0,0.0,20.0,1.0,,0.0,30.0,1.0,16.0,2.0,0.0,3.0,0.0,,0.0,0.0,0.0,0.0,3.0,0.0,0.0,30.0,0.0,0.0,6.0,5.0,1.0,8.0,0.0,0.0,3.0,1.0,53.0,2.0,0.0,1.0,2.0,0.0,0.0,55.0,0.0,4.0,,,5.0,,1.0,,,0.0,0.0,2.0,1.0,1.0,0.0,2.0,35.0,1.0,0.0,5.0,2.0,32.0,1.0,1.0,0.0,0.0,,6.0,0.0,0.0,12.0,130.0,,75.0,2.0,0.0,0.0,0.0,0.0,0.0,,0.0,0.0,0.0,5.0,8.0,0.0,,0.0,0.0
2024-10-14 00:00:00+00:00,122.0,,112.0,30.0,14.0,317.0,48.0,24.0,42.0,6.0,19.0,1.0,14.0,7.0,3.0,25.0,11.0,11.0,,1.0,0.0,0.0,4.0,9.0,0.0,1.0,3.0,,1.0,1.0,1.0,,,4.0,0.0,0.0,3.0,3.0,8.0,8.0,1.0,12.0,0.0,7.0,,4.0,0.0,28.0,2.0,,0.0,45.0,1.0,19.0,2.0,3.0,6.0,3.0,,0.0,0.0,1.0,1.0,2.0,3.0,3.0,40.0,0.0,1.0,2.0,11.0,1.0,9.0,1.0,3.0,2.0,119.0,81.0,2.0,1.0,0.0,21.0,0.0,0.0,53.0,0.0,1.0,,,14.0,,4.0,,,2.0,1.0,5.0,1.0,1.0,8.0,8.0,67.0,0.0,0.0,9.0,6.0,94.0,2.0,1.0,2.0,1.0,,8.0,0.0,0.0,31.0,154.0,,80.0,1.0,2.0,0.0,0.0,0.0,0.0,,1.0,3.0,1.0,11.0,2.0,0.0,,3.0,0.0
2024-10-15 00:00:00+00:00,93.0,,95.0,37.0,11.0,402.0,29.0,34.0,36.0,6.0,43.0,1.0,7.0,11.0,0.0,19.0,5.0,15.0,,1.0,1.0,0.0,1.0,4.0,5.0,0.0,2.0,,0.0,2.0,1.0,,,2.0,2.0,1.0,2.0,5.0,2.0,1.0,4.0,13.0,1.0,0.0,,7.0,1.0,14.0,2.0,,1.0,52.0,2.0,15.0,1.0,5.0,8.0,6.0,,0.0,0.0,1.0,1.0,0.0,1.0,2.0,29.0,5.0,3.0,1.0,15.0,0.0,8.0,1.0,3.0,0.0,144.0,64.0,2.0,3.0,1.0,12.0,0.0,0.0,67.0,0.0,1.0,,,13.0,,3.0,,,1.0,2.0,5.0,1.0,2.0,3.0,3.0,42.0,0.0,0.0,31.0,6.0,42.0,0.0,3.0,5.0,1.0,,2.0,0.0,0.0,39.0,174.0,,92.0,0.0,0.0,1.0,0.0,0.0,2.0,,0.0,2.0,12.0,6.0,11.0,0.0,,4.0,0.0
2024-10-16 00:00:00+00:00,114.0,,94.0,28.0,10.0,369.0,20.0,24.0,33.0,5.0,31.0,1.0,11.0,13.0,1.0,21.0,11.0,12.0,,2.0,0.0,4.0,4.0,15.0,0.0,0.0,3.0,,4.0,2.0,0.0,,,4.0,4.0,1.0,11.0,2.0,4.0,0.0,2.0,16.0,1.0,1.0,,16.0,0.0,26.0,2.0,,1.0,54.0,0.0,6.0,0.0,12.0,3.0,1.0,,0.0,1.0,3.0,4.0,6.0,7.0,5.0,26.0,34.0,0.0,4.0,12.0,5.0,16.0,0.0,4.0,1.0,79.0,59.0,6.0,2.0,1.0,11.0,0.0,0.0,99.0,0.0,1.0,,,5.0,,0.0,,,0.0,3.0,4.0,0.0,1.0,2.0,1.0,55.0,2.0,0.0,15.0,17.0,40.0,4.0,1.0,2.0,1.0,,1.0,0.0,2.0,51.0,174.0,,95.0,0.0,0.0,1.0,0.0,0.0,1.0,,0.0,3.0,20.0,5.0,7.0,0.0,,10.0,0.0
2024-10-17 00:00:00+00:00,104.0,,98.0,23.0,8.0,395.0,23.0,39.0,59.0,8.0,28.0,4.0,6.0,6.0,2.0,39.0,3.0,16.0,,1.0,0.0,1.0,5.0,13.0,1.0,1.0,4.0,,2.0,0.0,1.0,,,7.0,2.0,3.0,10.0,8.0,1.0,7.0,4.0,17.0,0.0,0.0,,3.0,1.0,24.0,3.0,,0.0,198.0,2.0,11.0,5.0,0.0,3.0,2.0,,0.0,0.0,2.0,3.0,0.0,5.0,0.0,64.0,0.0,2.0,8.0,16.0,1.0,10.0,0.0,1.0,0.0,66.0,55.0,3.0,1.0,2.0,42.0,0.0,0.0,118.0,0.0,1.0,,,9.0,,0.0,,,4.0,7.0,1.0,0.0,1.0,4.0,3.0,43.0,3.0,1.0,14.0,7.0,48.0,1.0,0.0,4.0,1.0,,5.0,0.0,0.0,46.0,175.0,,97.0,3.0,0.0,1.0,0.0,0.0,0.0,,0.0,3.0,4.0,4.0,2.0,2.0,,2.0,0.0
2024-10-18 00:00:00+00:00,122.0,,73.0,17.0,15.0,323.0,19.0,47.0,27.0,3.0,25.0,3.0,4.0,10.0,2.0,26.0,7.0,9.0,,5.0,0.0,0.0,9.0,7.0,1.0,2.0,4.0,,2.0,1.0,0.0,,,7.0,1.0,1.0,2.0,5.0,0.0,3.0,4.0,18.0,0.0,2.0,,1.0,0.0,29.0,0.0,,0.0,39.0,0.0,10.0,2.0,3.0,3.0,2.0,,0.0,0.0,2.0,1.0,3.0,2.0,0.0,50.0,11.0,1.0,4.0,9.0,0.0,15.0,0.0,3.0,0.0,171.0,43.0,1.0,0.0,0.0,52.0,0.0,0.0,90.0,0.0,2.0,,,15.0,,0.0,,,1.0,6.0,4.0,2.0,0.0,5.0,2.0,54.0,1.0,0.0,13.0,10.0,41.0,5.0,0.0,1.0,3.0,,3.0,1.0,1.0,73.0,166.0,,102.0,0.0,0.0,0.0,0.0,0.0,0.0,,0.0,5.0,4.0,28.0,6.0,0.0,,2.0,0.0
2024-10-19 00:00:00+00:00,61.0,,48.0,26.0,12.0,272.0,9.0,22.0,14.0,2.0,16.0,0.0,6.0,19.0,1.0,20.0,3.0,4.0,,0.0,0.0,2.0,3.0,8.0,1.0,0.0,3.0,,0.0,0.0,3.0,,,4.0,2.0,2.0,1.0,11.0,2.0,0.0,4.0,8.0,0.0,2.0,,1.0,0.0,13.0,1.0,,0.0,54.0,1.0,8.0,2.0,2.0,1.0,1.0,,0.0,0.0,0.0,0.0,1.0,2.0,3.0,54.0,3.0,1.0,2.0,4.0,2.0,10.0,0.0,0.0,2.0,7.0,46.0,0.0,0.0,1.0,25.0,0.0,0.0,60.0,0.0,3.0,,,5.0,,0.0,,,2.0,1.0,3.0,1.0,1.0,0.0,1.0,46.0,1.0,0.0,8.0,5.0,26.0,2.0,1.0,1.0,0.0,,0.0,0.0,1.0,36.0,157.0,,76.0,1.0,0.0,1.0,0.0,0.0,1.0,,0.0,1.0,0.0,5.0,5.0,0.0,,0.0,1.0
2024-10-20 00:00:00+00:00,99.0,,67.0,14.0,3.0,296.0,20.0,23.0,17.0,5.0,38.0,1.0,8.0,3.0,1.0,17.0,6.0,30.0,,0.0,0.0,1.0,4.0,2.0,2.0,0.0,2.0,,1.0,1.0,3.0,,,5.0,1.0,1.0,8.0,8.0,1.0,5.0,2.0,15.0,0.0,0.0,,2.0,0.0,16.0,5.0,,31.0,14.0,0.0,7.0,0.0,0.0,5.0,1.0,,0.0,0.0,0.0,0.0,2.0,0.0,2.0,51.0,12.0,2.0,2.0,30.0,2.0,7.0,0.0,1.0,2.0,67.0,37.0,1.0,0.0,0.0,26.0,0.0,0.0,45.0,0.0,1.0,,,17.0,,1.0,,,1.0,1.0,6.0,1.0,0.0,0.0,3.0,45.0,0.0,0.0,9.0,5.0,85.0,1.0,2.0,2.0,0.0,,6.0,0.0,1.0,38.0,161.0,,95.0,1.0,1.0,0.0,0.0,0.0,0.0,,0.0,2.0,1.0,1.0,6.0,1.0,,2.0,0.0
2024-10-21 00:00:00+00:00,93.0,,68.0,18.0,5.0,336.0,15.0,22.0,26.0,3.0,37.0,1.0,7.0,7.0,0.0,25.0,17.0,30.0,,3.0,0.0,1.0,3.0,11.0,0.0,1.0,8.0,,7.0,0.0,0.0,,,5.0,7.0,2.0,15.0,5.0,1.0,2.0,1.0,17.0,1.0,2.0,,2.0,2.0,16.0,1.0,,4.0,31.0,1.0,13.0,1.0,1.0,1.0,0.0,,0.0,0.0,1.0,1.0,0.0,4.0,5.0,41.0,2.0,0.0,2.0,29.0,0.0,6.0,1.0,1.0,2.0,2.0,37.0,4.0,2.0,0.0,26.0,0.0,0.0,73.0,0.0,1.0,,,10.0,,2.0,,,3.0,1.0,8.0,0.0,2.0,2.0,0.0,53.0,0.0,0.0,16.0,34.0,42.0,4.0,1.0,4.0,0.0,,12.0,0.0,0.0,59.0,188.0,,80.0,0.0,0.0,1.0,0.0,0.0,0.0,,1.0,2.0,4.0,7.0,4.0,0.0,,0.0,0.0
2024-10-22 00:00:00+00:00,202.0,,90.0,15.0,8.0,341.0,2.0,73.0,24.0,2.0,50.0,0.0,1.0,6.0,1.0,37.0,4.0,11.0,,0.0,0.0,1.0,3.0,18.0,1.0,1.0,5.0,,7.0,3.0,0.0,,,2.0,1.0,1.0,14.0,5.0,0.0,2.0,2.0,13.0,0.0,1.0,,6.0,2.0,15.0,3.0,,8.0,56.0,0.0,14.0,1.0,2.0,3.0,1.0,,2.0,2.0,1.0,6.0,2.0,7.0,4.0,23.0,6.0,0.0,10.0,11.0,0.0,16.0,0.0,0.0,2.0,3.0,44.0,0.0,5.0,0.0,22.0,0.0,0.0,119.0,0.0,0.0,,,8.0,,3.0,,,0.0,1.0,1.0,0.0,1.0,7.0,5.0,53.0,0.0,1.0,16.0,8.0,55.0,1.0,2.0,1.0,0.0,,2.0,0.0,0.0,40.0,177.0,,90.0,1.0,1.0,1.0,2.0,1.0,0.0,,0.0,1.0,8.0,3.0,8.0,1.0,,3.0,0.0
2024-10-23 00:00:00+00:00,200.0,,98.0,20.0,4.0,369.0,2.0,39.0,22.0,8.0,37.0,0.0,3.0,4.0,0.0,32.0,3.0,5.0,,0.0,0.0,3.0,3.0,6.0,1.0,0.0,5.0,,3.0,1.0,6.0,,,0.0,4.0,2.0,3.0,5.0,0.0,2.0,7.0,17.0,0.0,0.0,,6.0,0.0,26.0,3.0,,4.0,43.0,1.0,14.0,1.0,3.0,2.0,2.0,,1.0,0.0,1.0,1.0,7.0,0.0,3.0,50.0,9.0,0.0,3.0,4.0,2.0,13.0,0.0,2.0,0.0,4.0,34.0,2.0,2.0,0.0,14.0,0.0,0.0,92.0,0.0,2.0,,,11.0,,1.0,,,1.0,0.0,4.0,0.0,1.0,5.0,4.0,47.0,1.0,0.0,9.0,7.0,36.0,3.0,0.0,1.0,1.0,,3.0,1.0,1.0,68.0,172.0,,110.0,0.0,2.0,1.0,0.0,1.0,0.0,,0.0,3.0,10.0,2.0,4.0,0.0,,5.0,0.0
2024-10-24 00:00:00+00:00,153.0,,87.0,22.0,4.0,339.0,10.0,36.0,24.0,2.0,50.0,0.0,9.0,11.0,0.0,31.0,7.0,4.0,,0.0,0.0,0.0,6.0,17.0,1.0,1.0,2.0,,10.0,1.0,0.0,,,1.0,11.0,5.0,9.0,10.0,0.0,2.0,5.0,17.0,0.0,4.0,,2.0,0.0,24.0,0.0,,1.0,35.0,0.0,8.0,6.0,1.0,3.0,3.0,,1.0,2.0,0.0,0.0,1.0,3.0,2.0,45.0,2.0,0.0,7.0,4.0,1.0,14.0,0.0,1.0,2.0,3.0,26.0,3.0,2.0,1.0,26.0,0.0,0.0,126.0,0.0,0.0,,,10.0,,0.0,,,1.0,1.0,1.0,1.0,2.0,0.0,3.0,65.0,1.0,0.0,14.0,7.0,39.0,5.0,7.0,5.0,1.0,,1.0,1.0,1.0,27.0,175.0,,98.0,0.0,1.0,0.0,0.0,0.0,0.0,,1.0,1.0,12.0,1.0,9.0,1.0,,2.0,0.0
2024-10-25 00:00:00+00:00,132.0,,56.0,15.0,13.0,315.0,10.0,22.0,35.0,12.0,40.0,2.0,9.0,4.0,0.0,22.0,9.0,7.0,,2.0,0.0,0.0,8.0,16.0,3.0,0.0,6.0,,6.0,2.0,0.0,,,4.0,10.0,5.0,6.0,5.0,0.0,1.0,4.0,10.0,0.0,4.0,,2.0,0.0,25.0,4.0,,4.0,37.0,0.0,11.0,1.0,0.0,3.0,0.0,,1.0,0.0,2.0,0.0,0.0,1.0,3.0,28.0,4.0,0.0,4.0,7.0,0.0,14.0,0.0,3.0,3.0,1.0,47.0,3.0,1.0,3.0,6.0,0.0,0.0,74.0,0.0,1.0,,,11.0,,2.0,,,0.0,2.0,3.0,0.0,2.0,2.0,1.0,60.0,1.0,0.0,16.0,15.0,41.0,1.0,1.0,2.0,1.0,,0.0,1.0,1.0,9.0,138.0,,86.0,1.0,2.0,1.0,0.0,0.0,0.0,,0.0,1.0,3.0,5.0,4.0,0.0,,1.0,0.0
2024-10-26 00:00:00+00:00,86.0,,40.0,14.0,14.0,266.0,3.0,16.0,41.0,6.0,21.0,0.0,3.0,3.0,0.0,14.0,7.0,2.0,,0.0,0.0,0.0,2.0,12.0,1.0,0.0,5.0,,3.0,0.0,1.0,,,3.0,2.0,0.0,6.0,1.0,1.0,0.0,2.0,9.0,0.0,6.0,,17.0,0.0,23.0,3.0,,2.0,30.0,1.0,8.0,0.0,3.0,1.0,12.0,,0.0,0.0,1.0,1.0,0.0,1.0,0.0,19.0,2.0,0.0,2.0,2.0,0.0,10.0,0.0,0.0,0.0,1.0,39.0,1.0,0.0,4.0,4.0,0.0,0.0,70.0,0.0,0.0,,,8.0,,0.0,,,0.0,0.0,0.0,0.0,4.0,1.0,1.0,23.0,1.0,0.0,7.0,2.0,32.0,0.0,0.0,0.0,0.0,,2.0,0.0,2.0,30.0,119.0,,77.0,3.0,0.0,0.0,0.0,0.0,0.0,,0.0,4.0,2.0,0.0,3.0,0.0,,0.0,0.0
2024-10-27 00:00:00+00:00,116.0,,55.0,11.0,5.0,285.0,3.0,21.0,26.0,7.0,65.0,0.0,10.0,4.0,2.0,22.0,1.0,5.0,,0.0,0.0,2.0,3.0,15.0,0.0,0.0,4.0,,1.0,0.0,0.0,,,0.0,2.0,3.0,0.0,2.0,0.0,0.0,0.0,15.0,0.0,4.0,,18.0,0.0,8.0,0.0,,13.0,31.0,0.0,8.0,0.0,2.0,3.0,1.0,,0.0,1.0,1.0,0.0,2.0,2.0,1.0,32.0,1.0,0.0,4.0,5.0,1.0,9.0,0.0,1.0,3.0,2.0,28.0,0.0,0.0,0.0,9.0,0.0,0.0,77.0,1.0,2.0,,,11.0,,0.0,,,2.0,1.0,1.0,1.0,1.0,0.0,2.0,41.0,3.0,0.0,3.0,4.0,27.0,0.0,2.0,1.0,0.0,,1.0,0.0,0.0,32.0,115.0,,77.0,0.0,0.0,1.0,1.0,0.0,0.0,,0.0,0.0,0.0,0.0,5.0,0.0,,3.0,0.0
2024-10-28 00:00:00+00:00,120.0,,44.0,17.0,3.0,316.0,25.0,21.0,30.0,8.0,58.0,1.0,10.0,1.0,0.0,44.0,6.0,5.0,,2.0,0.0,2.0,23.0,4.0,4.0,1.0,6.0,,6.0,0.0,0.0,,,6.0,2.0,3.0,2.0,7.0,0.0,4.0,0.0,12.0,0.0,4.0,,20.0,0.0,24.0,3.0,,8.0,77.0,3.0,7.0,0.0,3.0,1.0,3.0,,0.0,0.0,1.0,3.0,1.0,2.0,6.0,31.0,8.0,0.0,4.0,5.0,1.0,12.0,2.0,1.0,3.0,5.0,34.0,1.0,1.0,0.0,12.0,0.0,0.0,81.0,0.0,0.0,,,8.0,,2.0,,,1.0,6.0,3.0,0.0,0.0,2.0,4.0,44.0,3.0,0.0,11.0,11.0,61.0,0.0,3.0,4.0,2.0,,1.0,0.0,1.0,37.0,133.0,,100.0,1.0,2.0,2.0,0.0,0.0,1.0,,0.0,2.0,2.0,1.0,3.0,1.0,,7.0,0.0
2024-10-29 00:00:00+00:00,138.0,,43.0,14.0,8.0,322.0,15.0,20.0,31.0,3.0,44.0,0.0,8.0,13.0,0.0,35.0,6.0,25.0,,0.0,0.0,5.0,14.0,14.0,0.0,0.0,2.0,,3.0,1.0,0.0,,,4.0,2.0,5.0,2.0,4.0,6.0,12.0,2.0,19.0,0.0,8.0,,21.0,0.0,28.0,3.0,,2.0,61.0,1.0,7.0,2.0,0.0,2.0,2.0,,0.0,0.0,2.0,1.0,2.0,1.0,4.0,37.0,0.0,1.0,7.0,25.0,0.0,8.0,0.0,6.0,2.0,2.0,72.0,1.0,2.0,3.0,2.0,0.0,0.0,93.0,0.0,1.0,,,11.0,,3.0,,,2.0,4.0,2.0,1.0,1.0,6.0,3.0,64.0,11.0,0.0,30.0,8.0,52.0,1.0,4.0,2.0,2.0,,2.0,0.0,0.0,41.0,170.0,,103.0,0.0,1.0,1.0,0.0,0.0,0.0,,0.0,1.0,9.0,2.0,7.0,0.0,,4.0,0.0
2024-10-30 00:00:00+00:00,245.0,,62.0,19.0,10.0,330.0,6.0,42.0,38.0,10.0,34.0,0.0,11.0,8.0,1.0,27.0,4.0,31.0,,1.0,0.0,6.0,22.0,4.0,3.0,0.0,18.0,,4.0,2.0,0.0,,,7.0,3.0,2.0,5.0,10.0,1.0,7.0,1.0,24.0,0.0,6.0,,10.0,0.0,16.0,2.0,,0.0,65.0,0.0,9.0,2.0,0.0,3.0,2.0,,1.0,0.0,2.0,7.0,3.0,0.0,1.0,23.0,1.0,0.0,4.0,31.0,1.0,13.0,0.0,1.0,0.0,3.0,44.0,3.0,1.0,1.0,4.0,0.0,0.0,104.0,0.0,1.0,,,4.0,,6.0,,,8.0,5.0,2.0,1.0,2.0,0.0,1.0,55.0,2.0,1.0,16.0,13.0,89.0,4.0,4.0,0.0,2.0,,3.0,0.0,1.0,35.0,156.0,,86.0,1.0,0.0,1.0,1.0,0.0,0.0,,0.0,1.0,16.0,2.0,9.0,0.0,,1.0,0.0
2024-10-31 00:00:00+00:00,236.0,,56.0,16.0,12.0,339.0,2.0,61.0,24.0,7.0,49.0,0.0,18.0,5.0,2.0,39.0,5.0,13.0,,0.0,0.0,5.0,25.0,5.0,3.0,0.0,7.0,,1.0,3.0,0.0,,,1.0,5.0,3.0,3.0,7.0,0.0,5.0,6.0,16.0,0.0,2.0,,12.0,0.0,11.0,4.0,,1.0,60.0,2.0,21.0,10.0,3.0,2.0,0.0,,2.0,2.0,0.0,10.0,12.0,0.0,0.0,23.0,3.0,1.0,6.0,13.0,1.0,12.0,0.0,0.0,0.0,3.0,62.0,3.0,0.0,2.0,10.0,0.0,0.0,106.0,0.0,1.0,,,9.0,,2.0,,,0.0,10.0,5.0,0.0,1.0,3.0,0.0,46.0,1.0,1.0,17.0,8.0,128.0,3.0,1.0,5.0,0.0,,2.0,0.0,2.0,33.0,146.0,,84.0,38.0,0.0,1.0,0.0,0.0,0.0,,2.0,3.0,9.0,3.0,3.0,0.0,,4.0,0.0
2024-11-01 00:00:00+00:00,123.0,,47.0,31.0,9.0,252.0,13.0,43.0,16.0,3.0,36.0,0.0,7.0,6.0,0.0,21.0,3.0,6.0,,1.0,0.0,2.0,21.0,10.0,8.0,1.0,3.0,,0.0,3.0,0.0,,,3.0,1.0,0.0,2.0,6.0,1.0,4.0,10.0,20.0,0.0,3.0,,7.0,1.0,19.0,2.0,,3.0,72.0,0.0,14.0,2.0,2.0,3.0,1.0,,1.0,0.0,2.0,3.0,5.0,1.0,1.0,43.0,1.0,0.0,7.0,6.0,0.0,8.0,0.0,2.0,2.0,0.0,57.0,0.0,1.0,1.0,1.0,0.0,0.0,66.0,0.0,1.0,,,7.0,,4.0,,,2.0,1.0,3.0,0.0,2.0,1.0,2.0,35.0,3.0,2.0,12.0,8.0,64.0,1.0,2.0,2.0,0.0,,6.0,0.0,1.0,33.0,127.0,,83.0,0.0,0.0,2.0,0.0,0.0,0.0,,0.0,2.0,3.0,2.0,4.0,1.0,,1.0,0.0
2024-11-02 00:00:00+00:00,63.0,,52.0,8.0,9.0,244.0,5.0,17.0,7.0,1.0,51.0,0.0,1.0,0.0,0.0,15.0,4.0,4.0,,0.0,0.0,0.0,17.0,5.0,0.0,1.0,0.0,,0.0,0.0,0.0,,,3.0,5.0,2.0,0.0,7.0,0.0,3.0,5.0,11.0,0.0,1.0,,6.0,0.0,25.0,2.0,,2.0,17.0,1.0,7.0,1.0,1.0,1.0,1.0,,2.0,0.0,1.0,0.0,0.0,1.0,0.0,28.0,0.0,0.0,3.0,4.0,1.0,7.0,0.0,1.0,0.0,0.0,41.0,0.0,7.0,1.0,7.0,0.0,0.0,29.0,0.0,2.0,,,10.0,,0.0,,,8.0,0.0,1.0,0.0,1.0,0.0,1.0,41.0,0.0,0.0,14.0,2.0,39.0,2.0,1.0,2.0,0.0,,0.0,0.0,0.0,25.0,119.0,,75.0,0.0,2.0,0.0,0.0,0.0,0.0,,0.0,1.0,3.0,0.0,2.0,0.0,,2.0,0.0
2024-11-03 00:00:00+00:00,71.0,,42.0,17.0,10.0,265.0,4.0,21.0,12.0,3.0,50.0,0.0,6.0,3.0,0.0,8.0,2.0,8.0,,0.0,0.0,1.0,18.0,11.0,0.0,0.0,1.0,,8.0,0.0,0.0,,,4.0,2.0,2.0,3.0,13.0,1.0,1.0,3.0,18.0,0.0,2.0,,7.0,0.0,18.0,1.0,,3.0,16.0,0.0,7.0,0.0,4.0,0.0,0.0,,0.0,0.0,1.0,0.0,1.0,0.0,0.0,26.0,0.0,0.0,3.0,8.0,1.0,7.0,0.0,1.0,3.0,3.0,29.0,0.0,0.0,0.0,1.0,0.0,0.0,28.0,0.0,1.0,,,7.0,,0.0,,,15.0,1.0,1.0,0.0,0.0,1.0,1.0,25.0,1.0,1.0,4.0,5.0,23.0,0.0,3.0,1.0,0.0,,10.0,0.0,0.0,22.0,133.0,,99.0,0.0,0.0,2.0,0.0,0.0,0.0,,0.0,0.0,3.0,3.0,2.0,0.0,,0.0,0.0
2024-11-04 00:00:00+00:00,117.0,,67.0,8.0,14.0,308.0,9.0,23.0,33.0,3.0,24.0,0.0,10.0,4.0,0.0,33.0,6.0,6.0,,1.0,0.0,3.0,16.0,6.0,1.0,0.0,5.0,,8.0,2.0,1.0,,,6.0,1.0,1.0,3.0,7.0,4.0,2.0,1.0,13.0,0.0,2.0,,5.0,2.0,25.0,1.0,,2.0,59.0,1.0,5.0,0.0,2.0,2.0,1.0,,0.0,0.0,1.0,0.0,15.0,2.0,1.0,29.0,2.0,0.0,8.0,6.0,0.0,8.0,1.0,1.0,0.0,1.0,55.0,2.0,4.0,2.0,1.0,0.0,0.0,74.0,0.0,2.0,,,8.0,,5.0,,,12.0,3.0,4.0,0.0,4.0,4.0,5.0,34.0,1.0,0.0,24.0,3.0,48.0,1.0,1.0,1.0,2.0,,6.0,0.0,5.0,25.0,160.0,,80.0,0.0,1.0,1.0,0.0,0.0,0.0,,0.0,8.0,9.0,1.0,4.0,0.0,,4.0,0.0
2024-11-05 00:00:00+00:00,127.0,,48.0,15.0,6.0,312.0,7.0,27.0,25.0,5.0,35.0,0.0,20.0,5.0,1.0,24.0,7.0,5.0,,1.0,0.0,1.0,3.0,3.0,1.0,0.0,4.0,,4.0,0.0,2.0,,,10.0,4.0,2.0,6.0,7.0,3.0,3.0,3.0,8.0,1.0,1.0,,5.0,0.0,22.0,2.0,,4.0,64.0,1.0,10.0,1.0,1.0,3.0,1.0,,0.0,0.0,3.0,1.0,17.0,2.0,0.0,47.0,1.0,1.0,3.0,5.0,0.0,21.0,0.0,0.0,2.0,1.0,39.0,4.0,1.0,1.0,3.0,0.0,0.0,64.0,0.0,4.0,,,11.0,,0.0,,,0.0,2.0,0.0,3.0,3.0,3.0,2.0,66.0,0.0,1.0,7.0,9.0,40.0,3.0,2.0,1.0,1.0,,6.0,0.0,2.0,33.0,122.0,,87.0,0.0,1.0,4.0,0.0,0.0,0.0,,1.0,1.0,9.0,1.0,5.0,0.0,,1.0,0.0
2024-11-06 00:00:00+00:00,126.0,,135.0,54.0,4.0,362.0,13.0,34.0,51.0,10.0,44.0,0.0,12.0,4.0,0.0,27.0,10.0,4.0,,1.0,0.0,1.0,3.0,19.0,1.0,0.0,2.0,,8.0,0.0,2.0,,,2.0,1.0,1.0,3.0,54.0,64.0,5.0,2.0,28.0,1.0,10.0,,25.0,4.0,22.0,3.0,,1.0,75.0,0.0,12.0,2.0,1.0,4.0,4.0,,0.0,1.0,0.0,1.0,10.0,0.0,1.0,19.0,3.0,1.0,5.0,4.0,0.0,8.0,0.0,2.0,3.0,2.0,41.0,6.0,0.0,1.0,11.0,0.0,0.0,97.0,0.0,1.0,,,11.0,,0.0,,,2.0,2.0,2.0,2.0,4.0,3.0,2.0,97.0,0.0,1.0,12.0,13.0,31.0,1.0,4.0,2.0,1.0,,5.0,0.0,2.0,23.0,188.0,,93.0,1.0,0.0,1.0,0.0,0.0,0.0,,0.0,4.0,5.0,0.0,9.0,0.0,,4.0,0.0
2024-11-07 00:00:00+00:00,134.0,,83.0,54.0,12.0,312.0,76.0,44.0,28.0,49.0,95.0,1.0,7.0,8.0,0.0,18.0,9.0,8.0,,5.0,0.0,1.0,10.0,22.0,2.0,0.0,7.0,,12.0,2.0,0.0,,,1.0,9.0,4.0,2.0,35.0,31.0,4.0,5.0,12.0,0.0,11.0,,21.0,2.0,18.0,3.0,,5.0,41.0,0.0,13.0,1.0,4.0,13.0,1.0,,1.0,3.0,1.0,0.0,10.0,2.0,0.0,21.0,1.0,0.0,8.0,8.0,0.0,18.0,1.0,4.0,3.0,3.0,43.0,4.0,5.0,2.0,30.0,0.0,0.0,93.0,0.0,1.0,,,8.0,,4.0,,,5.0,2.0,3.0,2.0,3.0,3.0,1.0,63.0,0.0,1.0,20.0,12.0,25.0,2.0,2.0,2.0,1.0,,2.0,0.0,1.0,22.0,169.0,,95.0,2.0,0.0,3.0,0.0,0.0,2.0,,0.0,5.0,8.0,3.0,12.0,1.0,,0.0,0.0
2024-11-08 00:00:00+00:00,161.0,,59.0,36.0,9.0,507.0,15.0,45.0,39.0,9.0,43.0,0.0,22.0,12.0,1.0,22.0,16.0,5.0,,2.0,0.0,2.0,3.0,5.0,1.0,0.0,2.0,,3.0,3.0,1.0,,,8.0,2.0,8.0,3.0,23.0,26.0,18.0,3.0,15.0,0.0,2.0,,9.0,2.0,22.0,6.0,,3.0,60.0,0.0,12.0,0.0,5.0,1.0,1.0,,3.0,2.0,1.0,7.0,4.0,1.0,1.0,19.0,1.0,0.0,6.0,5.0,2.0,12.0,2.0,3.0,2.0,4.0,56.0,4.0,1.0,1.0,26.0,0.0,0.0,70.0,0.0,2.0,,,14.0,,0.0,,,2.0,0.0,1.0,1.0,2.0,0.0,3.0,84.0,2.0,0.0,19.0,9.0,29.0,2.0,0.0,8.0,0.0,,5.0,0.0,1.0,34.0,157.0,,105.0,0.0,0.0,1.0,0.0,0.0,0.0,,0.0,2.0,7.0,0.0,2.0,0.0,,0.0,0.0
2024-11-09 00:00:00+00:00,102.0,,89.0,36.0,16.0,337.0,19.0,31.0,26.0,5.0,72.0,0.0,5.0,7.0,1.0,16.0,5.0,2.0,,1.0,0.0,0.0,13.0,5.0,8.0,0.0,2.0,,5.0,13.0,0.0,,,4.0,6.0,4.0,1.0,8.0,9.0,8.0,3.0,26.0,0.0,1.0,,6.0,3.0,21.0,0.0,,5.0,56.0,1.0,19.0,1.0,5.0,9.0,6.0,,0.0,2.0,1.0,2.0,2.0,1.0,3.0,20.0,0.0,1.0,3.0,2.0,0.0,8.0,2.0,4.0,0.0,1.0,43.0,1.0,0.0,10.0,24.0,0.0,0.0,53.0,0.0,4.0,,,13.0,,2.0,,,3.0,1.0,5.0,1.0,3.0,7.0,1.0,48.0,0.0,0.0,15.0,9.0,31.0,3.0,2.0,2.0,0.0,,5.0,0.0,5.0,22.0,143.0,,99.0,1.0,0.0,2.0,0.0,0.0,4.0,,0.0,2.0,4.0,1.0,2.0,0.0,,0.0,0.0
2024-11-10 00:00:00+00:00,131.0,,63.0,19.0,26.0,433.0,10.0,25.0,55.0,7.0,50.0,0.0,9.0,8.0,0.0,27.0,17.0,7.0,,2.0,0.0,1.0,4.0,3.0,1.0,5.0,2.0,,1.0,3.0,39.0,,,9.0,6.0,5.0,4.0,8.0,9.0,4.0,1.0,14.0,0.0,0.0,,8.0,1.0,21.0,2.0,,6.0,48.0,0.0,14.0,0.0,48.0,7.0,7.0,,0.0,5.0,0.0,3.0,3.0,1.0,5.0,20.0,5.0,1.0,4.0,7.0,1.0,17.0,3.0,1.0,2.0,0.0,55.0,1.0,0.0,6.0,15.0,0.0,0.0,70.0,0.0,2.0,,,12.0,,17.0,,,0.0,1.0,1.0,0.0,0.0,6.0,3.0,76.0,0.0,0.0,20.0,10.0,36.0,1.0,4.0,3.0,0.0,,8.0,0.0,0.0,20.0,179.0,,121.0,0.0,1.0,0.0,0.0,0.0,4.0,,0.0,1.0,4.0,0.0,5.0,1.0,,1.0,0.0
2024-11-11 00:00:00+00:00,189.0,,100.0,33.0,39.0,549.0,34.0,34.0,46.0,7.0,47.0,4.0,15.0,12.0,1.0,25.0,14.0,10.0,,4.0,0.0,4.0,28.0,10.0,2.0,0.0,4.0,,4.0,4.0,16.0,,,14.0,5.0,5.0,6.0,12.0,7.0,12.0,3.0,21.0,1.0,5.0,,15.0,5.0,34.0,3.0,,4.0,73.0,0.0,23.0,6.0,19.0,5.0,5.0,,1.0,3.0,1.0,3.0,0.0,1.0,1.0,22.0,0.0,2.0,13.0,10.0,0.0,18.0,1.0,7.0,3.0,8.0,66.0,7.0,2.0,2.0,8.0,0.0,0.0,97.0,0.0,3.0,,,15.0,,5.0,,,14.0,2.0,3.0,1.0,4.0,6.0,6.0,83.0,0.0,0.0,30.0,20.0,61.0,5.0,5.0,0.0,0.0,,3.0,0.0,2.0,36.0,304.0,,152.0,0.0,0.0,1.0,0.0,0.0,4.0,,0.0,2.0,6.0,3.0,4.0,1.0,,4.0,0.0
2024-11-12 00:00:00+00:00,198.0,,102.0,28.0,11.0,553.0,8.0,35.0,60.0,7.0,58.0,3.0,16.0,12.0,1.0,35.0,18.0,9.0,,1.0,0.0,3.0,10.0,8.0,1.0,0.0,4.0,,5.0,1.0,3.0,,,7.0,11.0,2.0,7.0,10.0,10.0,11.0,6.0,26.0,0.0,4.0,,8.0,4.0,18.0,1.0,,1.0,56.0,0.0,13.0,4.0,3.0,10.0,1.0,,2.0,0.0,1.0,4.0,2.0,2.0,1.0,32.0,2.0,0.0,16.0,9.0,2.0,21.0,0.0,3.0,0.0,2.0,64.0,7.0,1.0,0.0,7.0,0.0,0.0,105.0,1.0,3.0,,,26.0,,4.0,,,1.0,2.0,6.0,0.0,2.0,1.0,6.0,109.0,1.0,2.0,18.0,12.0,58.0,3.0,4.0,4.0,0.0,,4.0,0.0,1.0,46.0,307.0,,156.0,1.0,0.0,1.0,0.0,0.0,1.0,,1.0,3.0,6.0,5.0,13.0,0.0,,1.0,0.0
2024-11-13 00:00:00+00:00,179.0,,113.0,20.0,9.0,542.0,8.0,37.0,51.0,2.0,61.0,0.0,10.0,4.0,2.0,31.0,20.0,9.0,,4.0,0.0,3.0,10.0,19.0,3.0,0.0,5.0,,12.0,1.0,3.0,,,4.0,13.0,3.0,5.0,17.0,21.0,8.0,2.0,22.0,0.0,2.0,,6.0,3.0,28.0,0.0,,2.0,94.0,1.0,10.0,2.0,7.0,4.0,6.0,,0.0,0.0,3.0,8.0,2.0,1.0,2.0,23.0,0.0,2.0,6.0,9.0,1.0,17.0,0.0,3.0,2.0,12.0,70.0,6.0,0.0,2.0,9.0,0.0,0.0,75.0,0.0,6.0,,,15.0,,3.0,,,8.0,0.0,3.0,0.0,4.0,5.0,2.0,92.0,2.0,0.0,19.0,21.0,52.0,4.0,4.0,3.0,0.0,,7.0,0.0,2.0,26.0,281.0,,151.0,1.0,1.0,3.0,0.0,0.0,1.0,,6.0,7.0,6.0,0.0,7.0,1.0,,0.0,0.0
2024-11-14 00:00:00+00:00,279.0,,94.0,27.0,16.0,529.0,7.0,31.0,42.0,4.0,77.0,1.0,7.0,3.0,1.0,31.0,12.0,7.0,,4.0,1.0,2.0,9.0,12.0,1.0,0.0,9.0,,4.0,2.0,0.0,,,5.0,4.0,10.0,8.0,11.0,9.0,4.0,5.0,25.0,0.0,10.0,,5.0,0.0,22.0,1.0,,12.0,59.0,3.0,17.0,1.0,7.0,7.0,2.0,,0.0,1.0,3.0,3.0,3.0,1.0,4.0,30.0,5.0,3.0,9.0,7.0,0.0,17.0,2.0,9.0,0.0,0.0,65.0,5.0,1.0,5.0,11.0,0.0,0.0,110.0,0.0,4.0,,,25.0,,2.0,,,2.0,3.0,0.0,1.0,3.0,5.0,1.0,107.0,1.0,2.0,23.0,15.0,89.0,2.0,4.0,3.0,1.0,,3.0,0.0,0.0,36.0,226.0,,148.0,1.0,1.0,1.0,0.0,0.0,0.0,,5.0,3.0,13.0,1.0,10.0,1.0,,1.0,0.0
2024-11-15 00:00:00+00:00,155.0,,83.0,48.0,12.0,470.0,17.0,25.0,47.0,7.0,62.0,0.0,8.0,5.0,0.0,25.0,12.0,5.0,,3.0,0.0,0.0,8.0,11.0,1.0,0.0,5.0,,19.0,5.0,4.0,,,3.0,5.0,6.0,8.0,12.0,15.0,10.0,5.0,23.0,1.0,9.0,,3.0,4.0,34.0,2.0,,4.0,39.0,0.0,29.0,2.0,5.0,1.0,4.0,,0.0,0.0,1.0,1.0,4.0,1.0,1.0,28.0,2.0,3.0,4.0,5.0,1.0,17.0,0.0,11.0,2.0,1.0,71.0,10.0,2.0,6.0,5.0,0.0,0.0,101.0,0.0,2.0,,,16.0,,6.0,,,1.0,3.0,1.0,3.0,0.0,8.0,4.0,94.0,1.0,2.0,21.0,14.0,76.0,2.0,2.0,2.0,2.0,,1.0,0.0,0.0,31.0,255.0,,119.0,1.0,0.0,3.0,0.0,0.0,1.0,,0.0,2.0,4.0,0.0,1.0,0.0,,4.0,0.0
2024-11-16 00:00:00+00:00,162.0,204.0,66.0,23.0,28.0,466.0,5.0,30.0,74.0,4.0,44.0,0.0,5.0,6.0,0.0,20.0,15.0,4.0,0.0,2.0,1.0,0.0,3.0,4.0,1.0,0.0,3.0,,8.0,2.0,0.0,,,13.0,1.0,4.0,6.0,8.0,3.0,41.0,5.0,22.0,0.0,3.0,72.0,3.0,1.0,28.0,2.0,,2.0,102.0,0.0,17.0,4.0,3.0,3.0,1.0,,0.0,0.0,0.0,0.0,1.0,0.0,1.0,14.0,1.0,0.0,5.0,4.0,1.0,8.0,3.0,2.0,1.0,2.0,35.0,2.0,2.0,1.0,2.0,0.0,0.0,69.0,0.0,0.0,,,14.0,,1.0,,,1.0,1.0,0.0,0.0,1.0,2.0,2.0,97.0,0.0,3.0,15.0,9.0,57.0,3.0,1.0,0.0,0.0,,8.0,0.0,0.0,30.0,181.0,,126.0,3.0,0.0,0.0,0.0,0.0,1.0,,0.0,6.0,0.0,0.0,0.0,0.0,,1.0,1.0
2024-11-17 00:00:00+00:00,134.0,177.0,55.0,13.0,25.0,516.0,7.0,28.0,44.0,7.0,78.0,0.0,8.0,3.0,1.0,18.0,7.0,7.0,3.0,1.0,0.0,2.0,6.0,3.0,0.0,0.0,3.0,,2.0,0.0,0.0,,,7.0,13.0,6.0,8.0,8.0,8.0,41.0,2.0,26.0,0.0,1.0,55.0,4.0,1.0,24.0,0.0,,1.0,61.0,0.0,11.0,1.0,4.0,8.0,11.0,,0.0,2.0,0.0,1.0,1.0,1.0,2.0,19.0,2.0,1.0,6.0,7.0,0.0,23.0,0.0,4.0,0.0,1.0,55.0,22.0,0.0,6.0,7.0,0.0,0.0,73.0,0.0,1.0,,,21.0,,1.0,,,2.0,1.0,0.0,1.0,3.0,2.0,4.0,84.0,0.0,0.0,11.0,15.0,65.0,3.0,3.0,2.0,0.0,,3.0,0.0,0.0,28.0,169.0,,141.0,1.0,0.0,0.0,0.0,0.0,2.0,,2.0,4.0,11.0,0.0,3.0,0.0,,0.0,0.0
2024-11-18 00:00:00+00:00,205.0,203.0,66.0,13.0,21.0,511.0,16.0,30.0,34.0,12.0,69.0,0.0,7.0,9.0,1.0,28.0,11.0,7.0,13.0,2.0,0.0,1.0,4.0,10.0,1.0,0.0,28.0,,5.0,2.0,0.0,,,14.0,5.0,6.0,2.0,10.0,7.0,30.0,4.0,20.0,0.0,16.0,78.0,5.0,0.0,30.0,1.0,,5.0,81.0,0.0,13.0,1.0,6.0,26.0,7.0,,0.0,2.0,0.0,1.0,1.0,2.0,0.0,27.0,0.0,0.0,11.0,7.0,2.0,18.0,2.0,4.0,0.0,0.0,78.0,8.0,0.0,3.0,6.0,0.0,0.0,87.0,0.0,6.0,,,25.0,,2.0,,,1.0,0.0,1.0,0.0,4.0,1.0,1.0,104.0,0.0,1.0,16.0,12.0,65.0,3.0,1.0,10.0,0.0,,3.0,0.0,0.0,49.0,204.0,,128.0,1.0,0.0,2.0,0.0,0.0,1.0,,0.0,2.0,2.0,2.0,10.0,0.0,,2.0,0.0
2024-11-19 00:00:00+00:00,200.0,226.0,70.0,11.0,18.0,521.0,9.0,39.0,31.0,15.0,76.0,0.0,11.0,1.0,1.0,40.0,8.0,14.0,11.0,0.0,0.0,5.0,17.0,11.0,5.0,0.0,8.0,,5.0,1.0,3.0,,,9.0,6.0,6.0,4.0,10.0,6.0,5.0,4.0,21.0,1.0,3.0,125.0,11.0,0.0,35.0,2.0,,5.0,74.0,1.0,13.0,3.0,2.0,8.0,1.0,,0.0,2.0,1.0,0.0,4.0,2.0,3.0,14.0,2.0,3.0,8.0,14.0,1.0,16.0,2.0,7.0,2.0,1.0,76.0,11.0,0.0,5.0,3.0,0.0,0.0,58.0,0.0,1.0,,,23.0,,0.0,,,2.0,6.0,7.0,0.0,5.0,4.0,8.0,78.0,1.0,1.0,24.0,20.0,50.0,4.0,3.0,4.0,1.0,,6.0,0.0,1.0,27.0,234.0,,161.0,2.0,0.0,1.0,0.0,0.0,1.0,,1.0,2.0,4.0,0.0,10.0,0.0,,2.0,0.0
2024-11-20 00:00:00+00:00,186.0,204.0,74.0,27.0,21.0,538.0,15.0,46.0,33.0,11.0,64.0,0.0,5.0,5.0,4.0,30.0,13.0,8.0,14.0,5.0,0.0,7.0,7.0,5.0,14.0,1.0,5.0,,3.0,1.0,2.0,,,8.0,3.0,6.0,2.0,16.0,14.0,10.0,1.0,35.0,0.0,5.0,78.0,5.0,2.0,34.0,1.0,,5.0,40.0,0.0,9.0,4.0,4.0,9.0,4.0,,0.0,0.0,1.0,0.0,2.0,2.0,4.0,30.0,0.0,3.0,3.0,8.0,1.0,14.0,1.0,3.0,6.0,4.0,67.0,13.0,2.0,3.0,2.0,1.0,0.0,90.0,0.0,6.0,,,13.0,,7.0,,,0.0,0.0,3.0,2.0,6.0,5.0,7.0,74.0,1.0,1.0,22.0,15.0,68.0,2.0,4.0,4.0,0.0,,10.0,0.0,0.0,33.0,246.0,,134.0,1.0,0.0,1.0,0.0,0.0,0.0,,0.0,3.0,20.0,3.0,10.0,0.0,,3.0,0.0
2024-11-21 00:00:00+00:00,135.0,232.0,63.0,23.0,10.0,622.0,15.0,48.0,34.0,6.0,80.0,0.0,10.0,6.0,2.0,30.0,28.0,7.0,41.0,1.0,0.0,4.0,11.0,5.0,0.0,0.0,9.0,,1.0,2.0,1.0,,,6.0,7.0,2.0,5.0,21.0,4.0,10.0,3.0,30.0,0.0,3.0,72.0,17.0,1.0,31.0,2.0,,3.0,72.0,1.0,13.0,2.0,2.0,3.0,12.0,,0.0,1.0,1.0,2.0,4.0,4.0,3.0,31.0,0.0,1.0,10.0,7.0,0.0,16.0,3.0,15.0,2.0,3.0,71.0,4.0,4.0,3.0,3.0,0.0,0.0,83.0,0.0,5.0,,,24.0,,0.0,,,0.0,1.0,7.0,4.0,2.0,6.0,7.0,93.0,1.0,3.0,20.0,11.0,53.0,3.0,6.0,2.0,0.0,,2.0,1.0,2.0,30.0,300.0,,137.0,0.0,1.0,0.0,0.0,0.0,0.0,,2.0,0.0,14.0,1.0,9.0,1.0,,0.0,0.0
2024-11-22 00:00:00+00:00,164.0,276.0,89.0,22.0,15.0,640.0,10.0,29.0,66.0,4.0,97.0,0.0,8.0,7.0,0.0,26.0,27.0,7.0,20.0,1.0,0.0,5.0,7.0,9.0,1.0,0.0,1.0,,2.0,3.0,2.0,,,13.0,6.0,5.0,7.0,12.0,0.0,9.0,4.0,18.0,0.0,5.0,68.0,7.0,4.0,30.0,2.0,,2.0,102.0,0.0,28.0,0.0,3.0,6.0,3.0,,0.0,1.0,1.0,4.0,4.0,5.0,2.0,26.0,1.0,4.0,13.0,7.0,1.0,17.0,3.0,3.0,1.0,3.0,80.0,8.0,1.0,2.0,16.0,0.0,0.0,84.0,0.0,2.0,,,22.0,,3.0,,,0.0,4.0,6.0,1.0,3.0,7.0,5.0,100.0,1.0,1.0,20.0,13.0,53.0,4.0,3.0,3.0,1.0,,5.0,0.0,1.0,34.0,318.0,,139.0,0.0,0.0,1.0,0.0,0.0,1.0,,2.0,0.0,5.0,1.0,7.0,0.0,,2.0,0.0
2024-11-23 00:00:00+00:00,184.0,257.0,98.0,22.0,23.0,731.0,16.0,52.0,72.0,4.0,89.0,0.0,9.0,3.0,1.0,27.0,18.0,9.0,5.0,0.0,0.0,0.0,10.0,21.0,7.0,0.0,6.0,,8.0,2.0,3.0,,,17.0,0.0,5.0,44.0,11.0,3.0,33.0,3.0,11.0,1.0,5.0,62.0,12.0,2.0,39.0,4.0,,2.0,71.0,1.0,20.0,1.0,6.0,5.0,8.0,,0.0,0.0,0.0,4.0,2.0,8.0,4.0,21.0,0.0,3.0,13.0,9.0,0.0,33.0,4.0,5.0,1.0,3.0,63.0,8.0,1.0,1.0,55.0,0.0,0.0,86.0,0.0,6.0,,,35.0,,1.0,,,2.0,0.0,1.0,4.0,2.0,6.0,2.0,98.0,0.0,2.0,17.0,9.0,51.0,2.0,5.0,5.0,0.0,,4.0,0.0,0.0,38.0,290.0,,180.0,0.0,0.0,0.0,0.0,0.0,5.0,,0.0,1.0,1.0,0.0,7.0,0.0,,0.0,0.0
2024-11-24 00:00:00+00:00,166.0,200.0,237.0,28.0,11.0,662.0,9.0,32.0,37.0,7.0,59.0,0.0,17.0,3.0,0.0,17.0,7.0,14.0,4.0,2.0,0.0,3.0,25.0,19.0,2.0,0.0,4.0,,6.0,1.0,1.0,,,24.0,1.0,8.0,12.0,9.0,2.0,48.0,7.0,7.0,0.0,2.0,75.0,5.0,1.0,26.0,3.0,,3.0,44.0,0.0,24.0,2.0,6.0,6.0,1.0,,0.0,3.0,0.0,2.0,1.0,3.0,1.0,30.0,1.0,1.0,3.0,14.0,0.0,11.0,1.0,0.0,1.0,3.0,58.0,2.0,0.0,3.0,14.0,0.0,0.0,62.0,1.0,11.0,,,16.0,,4.0,,,1.0,2.0,8.0,0.0,2.0,6.0,6.0,69.0,0.0,1.0,16.0,8.0,38.0,1.0,2.0,3.0,0.0,,4.0,0.0,0.0,30.0,255.0,,128.0,2.0,1.0,0.0,0.0,1.0,0.0,,0.0,1.0,2.0,1.0,3.0,0.0,,3.0,0.0
2024-11-25 00:00:00+00:00,143.0,207.0,199.0,12.0,17.0,533.0,14.0,27.0,41.0,20.0,72.0,0.0,12.0,7.0,1.0,18.0,14.0,6.0,16.0,1.0,0.0,3.0,18.0,35.0,4.0,45.0,3.0,,6.0,0.0,0.0,,,13.0,6.0,2.0,9.0,7.0,4.0,26.0,4.0,19.0,0.0,6.0,87.0,0.0,3.0,29.0,3.0,,3.0,71.0,0.0,13.0,6.0,0.0,2.0,5.0,,0.0,0.0,2.0,1.0,3.0,4.0,8.0,28.0,0.0,1.0,7.0,6.0,0.0,16.0,1.0,2.0,1.0,4.0,74.0,15.0,1.0,2.0,3.0,0.0,0.0,76.0,0.0,6.0,,,19.0,,3.0,,,1.0,2.0,4.0,2.0,3.0,1.0,3.0,70.0,0.0,0.0,18.0,2.0,154.0,4.0,4.0,5.0,1.0,,13.0,0.0,0.0,45.0,233.0,,171.0,1.0,0.0,2.0,0.0,0.0,5.0,,0.0,1.0,6.0,0.0,1.0,0.0,,5.0,0.0
2024-11-26 00:00:00+00:00,166.0,182.0,268.0,24.0,9.0,557.0,9.0,34.0,75.0,21.0,91.0,0.0,9.0,3.0,0.0,17.0,15.0,19.0,19.0,3.0,0.0,2.0,13.0,10.0,9.0,282.0,13.0,,4.0,2.0,2.0,,,9.0,6.0,3.0,8.0,17.0,8.0,12.0,2.0,15.0,0.0,2.0,83.0,17.0,9.0,27.0,4.0,,1.0,60.0,0.0,11.0,0.0,0.0,20.0,0.0,,3.0,0.0,7.0,2.0,4.0,3.0,5.0,38.0,2.0,3.0,14.0,18.0,2.0,14.0,1.0,3.0,3.0,2.0,104.0,6.0,0.0,2.0,14.0,0.0,0.0,166.0,0.0,1.0,,,14.0,,4.0,,,1.0,0.0,1.0,1.0,5.0,4.0,4.0,92.0,4.0,1.0,30.0,6.0,53.0,2.0,4.0,3.0,1.0,,5.0,0.0,0.0,42.0,274.0,,150.0,1.0,0.0,2.0,1.0,1.0,0.0,,0.0,5.0,7.0,0.0,16.0,0.0,,2.0,0.0
2024-11-27 00:00:00+00:00,151.0,181.0,271.0,57.0,24.0,581.0,25.0,42.0,51.0,9.0,56.0,0.0,10.0,7.0,0.0,16.0,69.0,13.0,31.0,2.0,0.0,6.0,8.0,19.0,2.0,159.0,7.0,,4.0,0.0,6.0,,,7.0,2.0,2.0,7.0,14.0,5.0,11.0,24.0,24.0,1.0,2.0,75.0,4.0,3.0,19.0,5.0,,4.0,71.0,2.0,14.0,0.0,2.0,6.0,12.0,,1.0,1.0,3.0,5.0,1.0,6.0,1.0,27.0,4.0,1.0,6.0,13.0,1.0,16.0,3.0,7.0,1.0,4.0,56.0,2.0,1.0,5.0,44.0,0.0,0.0,221.0,0.0,3.0,,,38.0,,1.0,,,2.0,0.0,2.0,1.0,0.0,10.0,2.0,57.0,1.0,2.0,18.0,7.0,56.0,2.0,3.0,4.0,0.0,,2.0,0.0,0.0,30.0,235.0,,115.0,2.0,1.0,3.0,0.0,0.0,0.0,,0.0,3.0,6.0,8.0,8.0,0.0,,0.0,0.0
2024-11-28 00:00:00+00:00,149.0,440.0,139.0,24.0,22.0,537.0,30.0,38.0,33.0,2.0,302.0,1.0,21.0,7.0,1.0,22.0,29.0,10.0,6.0,1.0,0.0,2.0,6.0,27.0,9.0,0.0,3.0,,5.0,4.0,1.0,,,3.0,6.0,3.0,11.0,19.0,2.0,11.0,14.0,17.0,0.0,2.0,74.0,4.0,1.0,30.0,0.0,,2.0,79.0,1.0,14.0,2.0,0.0,3.0,4.0,,3.0,7.0,0.0,2.0,1.0,1.0,5.0,39.0,0.0,0.0,4.0,10.0,1.0,19.0,0.0,4.0,2.0,1.0,61.0,10.0,0.0,2.0,10.0,0.0,0.0,195.0,0.0,3.0,,,18.0,,3.0,,,0.0,1.0,2.0,1.0,1.0,2.0,1.0,57.0,2.0,0.0,24.0,9.0,40.0,3.0,1.0,4.0,0.0,,2.0,0.0,0.0,28.0,177.0,,103.0,2.0,0.0,5.0,0.0,0.0,0.0,,2.0,2.0,9.0,3.0,6.0,0.0,,0.0,0.0
2024-11-29 00:00:00+00:00,173.0,826.0,251.0,29.0,25.0,509.0,34.0,33.0,34.0,7.0,372.0,0.0,13.0,2.0,1.0,17.0,29.0,10.0,16.0,1.0,0.0,4.0,14.0,17.0,4.0,0.0,3.0,,8.0,3.0,3.0,,,5.0,2.0,1.0,4.0,14.0,5.0,7.0,15.0,16.0,2.0,4.0,72.0,4.0,0.0,25.0,3.0,,3.0,96.0,0.0,20.0,10.0,5.0,2.0,1.0,,0.0,3.0,0.0,3.0,2.0,5.0,8.0,32.0,1.0,0.0,9.0,10.0,1.0,21.0,1.0,3.0,5.0,2.0,35.0,8.0,1.0,2.0,18.0,0.0,0.0,193.0,0.0,2.0,,,21.0,,0.0,,,0.0,1.0,1.0,4.0,2.0,6.0,4.0,81.0,0.0,1.0,28.0,21.0,73.0,2.0,4.0,2.0,2.0,,6.0,0.0,1.0,26.0,214.0,,114.0,0.0,1.0,3.0,0.0,0.0,1.0,,0.0,1.0,1.0,0.0,7.0,2.0,,1.0,0.0
2024-11-30 00:00:00+00:00,163.0,754.0,181.0,31.0,38.0,635.0,15.0,32.0,23.0,10.0,368.0,0.0,5.0,7.0,0.0,17.0,42.0,5.0,13.0,2.0,0.0,3.0,9.0,10.0,6.0,1.0,6.0,,7.0,0.0,5.0,,,13.0,3.0,3.0,5.0,6.0,5.0,15.0,8.0,9.0,0.0,8.0,67.0,1.0,4.0,21.0,3.0,,8.0,123.0,1.0,6.0,3.0,37.0,3.0,3.0,,2.0,10.0,1.0,0.0,3.0,5.0,10.0,44.0,1.0,1.0,9.0,5.0,0.0,23.0,0.0,7.0,11.0,0.0,42.0,4.0,2.0,0.0,29.0,0.0,0.0,137.0,0.0,4.0,,,25.0,,9.0,,,1.0,3.0,0.0,2.0,0.0,5.0,6.0,113.0,0.0,1.0,13.0,24.0,51.0,0.0,3.0,4.0,8.0,,3.0,2.0,0.0,22.0,232.0,,138.0,1.0,1.0,2.0,0.0,0.0,0.0,,0.0,3.0,3.0,0.0,5.0,1.0,,1.0,0.0
2024-12-01 00:00:00+00:00,143.0,648.0,88.0,36.0,26.0,588.0,12.0,42.0,37.0,8.0,349.0,0.0,3.0,5.0,2.0,21.0,38.0,10.0,3.0,1.0,0.0,1.0,14.0,23.0,26.0,0.0,7.0,,23.0,1.0,9.0,,,17.0,8.0,2.0,9.0,16.0,3.0,28.0,11.0,18.0,1.0,3.0,72.0,9.0,2.0,26.0,1.0,,4.0,83.0,1.0,18.0,1.0,6.0,6.0,0.0,,0.0,4.0,1.0,6.0,3.0,7.0,1.0,20.0,5.0,0.0,8.0,10.0,5.0,17.0,0.0,5.0,7.0,3.0,51.0,10.0,1.0,0.0,3.0,0.0,0.0,155.0,0.0,2.0,,,26.0,,5.0,,,0.0,1.0,2.0,2.0,1.0,6.0,2.0,125.0,0.0,2.0,23.0,14.0,46.0,3.0,1.0,3.0,6.0,,3.0,0.0,2.0,46.0,224.0,,142.0,1.0,1.0,0.0,0.0,1.0,0.0,,0.0,2.0,0.0,0.0,3.0,0.0,,2.0,0.0
2024-12-02 00:00:00+00:00,359.0,576.0,101.0,53.0,24.0,767.0,17.0,40.0,42.0,2.0,232.0,0.0,22.0,5.0,1.0,16.0,25.0,11.0,5.0,2.0,0.0,3.0,13.0,25.0,11.0,1.0,11.0,,14.0,3.0,5.0,,,17.0,5.0,5.0,12.0,13.0,0.0,28.0,12.0,19.0,0.0,3.0,83.0,3.0,1.0,35.0,3.0,,1.0,129.0,1.0,11.0,1.0,39.0,9.0,1.0,,2.0,2.0,2.0,11.0,3.0,5.0,1.0,32.0,3.0,1.0,10.0,11.0,1.0,26.0,2.0,4.0,4.0,0.0,55.0,15.0,0.0,2.0,41.0,0.0,0.0,139.0,0.0,0.0,,,25.0,,3.0,,,1.0,5.0,2.0,3.0,3.0,6.0,8.0,181.0,0.0,1.0,25.0,21.0,60.0,1.0,3.0,4.0,2.0,,11.0,1.0,3.0,52.0,252.0,,169.0,3.0,1.0,6.0,0.0,0.0,0.0,,1.0,8.0,3.0,0.0,4.0,1.0,,0.0,0.0
2024-12-03 00:00:00+00:00,292.0,335.0,282.0,55.0,119.0,695.0,164.0,44.0,36.0,3.0,41.0,0.0,6.0,4.0,1.0,39.0,26.0,16.0,9.0,5.0,0.0,7.0,13.0,26.0,5.0,3.0,13.0,,14.0,1.0,10.0,,,70.0,8.0,4.0,15.0,17.0,3.0,34.0,7.0,24.0,1.0,19.0,62.0,9.0,3.0,24.0,3.0,,4.0,156.0,1.0,18.0,1.0,5.0,5.0,2.0,,1.0,1.0,2.0,4.0,2.0,2.0,3.0,33.0,4.0,2.0,6.0,16.0,2.0,28.0,2.0,2.0,4.0,2.0,62.0,18.0,3.0,4.0,58.0,0.0,0.0,123.0,0.0,5.0,,,33.0,,2.0,,,0.0,5.0,3.0,2.0,5.0,7.0,9.0,111.0,1.0,2.0,34.0,18.0,70.0,1.0,3.0,7.0,4.0,,11.0,0.0,2.0,42.0,301.0,,149.0,2.0,1.0,3.0,0.0,0.0,0.0,,0.0,6.0,4.0,0.0,9.0,0.0,,2.0,0.0
2024-12-04 00:00:00+00:00,220.0,410.0,481.0,58.0,80.0,720.0,25.0,60.0,32.0,6.0,63.0,0.0,9.0,14.0,1.0,33.0,25.0,18.0,1.0,18.0,1.0,6.0,16.0,23.0,19.0,0.0,9.0,,14.0,4.0,15.0,,,15.0,7.0,4.0,10.0,16.0,5.0,56.0,8.0,11.0,1.0,16.0,77.0,20.0,3.0,25.0,4.0,,6.0,138.0,3.0,29.0,1.0,5.0,25.0,2.0,,2.0,3.0,2.0,4.0,5.0,4.0,4.0,59.0,1.0,5.0,10.0,18.0,2.0,24.0,1.0,5.0,3.0,3.0,51.0,8.0,1.0,1.0,57.0,0.0,0.0,139.0,0.0,4.0,,,51.0,,14.0,,,1.0,2.0,2.0,4.0,1.0,11.0,7.0,121.0,1.0,2.0,24.0,19.0,65.0,4.0,6.0,4.0,0.0,,2.0,0.0,1.0,46.0,275.0,,182.0,3.0,1.0,0.0,0.0,0.0,1.0,,1.0,4.0,6.0,0.0,4.0,0.0,,1.0,0.0
2024-12-05 00:00:00+00:00,203.0,361.0,241.0,20.0,27.0,781.0,19.0,52.0,61.0,6.0,42.0,1.0,4.0,9.0,3.0,14.0,50.0,5.0,36.0,4.0,0.0,4.0,14.0,15.0,6.0,0.0,9.0,,9.0,4.0,30.0,,,17.0,3.0,3.0,7.0,18.0,7.0,27.0,3.0,25.0,0.0,10.0,94.0,10.0,3.0,29.0,1.0,,3.0,120.0,0.0,14.0,0.0,5.0,16.0,6.0,,0.0,2.0,0.0,4.0,3.0,4.0,1.0,46.0,1.0,2.0,18.0,5.0,0.0,26.0,5.0,6.0,6.0,3.0,68.0,11.0,1.0,2.0,50.0,0.0,0.0,186.0,0.0,3.0,,,21.0,,3.0,,,1.0,4.0,1.0,4.0,3.0,2.0,1.0,110.0,2.0,2.0,26.0,14.0,67.0,4.0,4.0,3.0,0.0,,4.0,0.0,1.0,47.0,372.0,,215.0,4.0,1.0,5.0,0.0,0.0,0.0,,1.0,6.0,8.0,2.0,5.0,0.0,,4.0,0.0
2024-12-06 00:00:00+00:00,159.0,311.0,128.0,27.0,25.0,897.0,38.0,51.0,60.0,6.0,43.0,1.0,6.0,5.0,2.0,24.0,36.0,56.0,50.0,6.0,0.0,7.0,11.0,33.0,8.0,1.0,56.0,,23.0,1.0,34.0,,,28.0,7.0,86.0,17.0,13.0,1.0,14.0,19.0,21.0,3.0,8.0,109.0,3.0,3.0,27.0,3.0,,2.0,272.0,0.0,21.0,2.0,7.0,11.0,2.0,,0.0,6.0,0.0,3.0,5.0,5.0,1.0,32.0,1.0,2.0,12.0,54.0,3.0,26.0,2.0,5.0,6.0,4.0,68.0,5.0,0.0,2.0,100.0,0.0,0.0,145.0,0.0,4.0,,,34.0,,2.0,,,2.0,0.0,2.0,3.0,3.0,7.0,2.0,89.0,0.0,2.0,23.0,16.0,93.0,4.0,4.0,2.0,0.0,,5.0,0.0,1.0,62.0,319.0,,173.0,0.0,0.0,4.0,5.0,0.0,0.0,,0.0,6.0,3.0,0.0,6.0,2.0,,1.0,0.0
2024-12-07 00:00:00+00:00,244.0,274.0,116.0,35.0,22.0,787.0,11.0,33.0,35.0,9.0,33.0,0.0,5.0,8.0,1.0,13.0,25.0,8.0,19.0,3.0,1.0,0.0,144.0,4.0,4.0,0.0,23.0,,1.0,1.0,27.0,,,13.0,17.0,14.0,28.0,10.0,5.0,22.0,12.0,17.0,0.0,6.0,67.0,1.0,2.0,23.0,3.0,,2.0,180.0,1.0,21.0,1.0,2.0,8.0,15.0,,1.0,1.0,0.0,5.0,12.0,2.0,2.0,29.0,0.0,1.0,2.0,8.0,2.0,18.0,1.0,5.0,5.0,2.0,73.0,1.0,1.0,0.0,31.0,0.0,0.0,92.0,0.0,8.0,,,20.0,,1.0,,,0.0,2.0,2.0,3.0,2.0,2.0,2.0,65.0,0.0,1.0,21.0,7.0,90.0,2.0,1.0,5.0,0.0,,2.0,0.0,1.0,28.0,215.0,,166.0,2.0,0.0,0.0,0.0,0.0,0.0,,0.0,5.0,3.0,0.0,0.0,0.0,,1.0,0.0
2024-12-08 00:00:00+00:00,185.0,234.0,109.0,22.0,12.0,822.0,9.0,37.0,33.0,10.0,63.0,0.0,2.0,1.0,1.0,7.0,16.0,29.0,11.0,1.0,1.0,3.0,149.0,11.0,0.0,0.0,5.0,,9.0,0.0,7.0,,,8.0,4.0,11.0,33.0,11.0,2.0,21.0,10.0,17.0,0.0,2.0,72.0,8.0,1.0,22.0,0.0,,8.0,123.0,0.0,11.0,1.0,4.0,10.0,4.0,,0.0,1.0,0.0,0.0,4.0,1.0,0.0,21.0,1.0,0.0,5.0,29.0,0.0,25.0,1.0,2.0,7.0,1.0,81.0,1.0,0.0,0.0,43.0,0.0,0.0,101.0,0.0,3.0,,,15.0,,0.0,,,1.0,1.0,5.0,1.0,1.0,0.0,14.0,58.0,0.0,1.0,5.0,7.0,88.0,5.0,1.0,5.0,1.0,,4.0,0.0,0.0,41.0,248.0,,144.0,1.0,0.0,1.0,0.0,0.0,0.0,,1.0,0.0,1.0,0.0,5.0,0.0,,2.0,0.0
2024-12-09 00:00:00+00:00,250.0,273.0,98.0,19.0,37.0,828.0,18.0,38.0,40.0,1.0,48.0,0.0,3.0,2.0,2.0,14.0,17.0,27.0,3.0,2.0,0.0,0.0,43.0,13.0,8.0,0.0,4.0,,8.0,0.0,11.0,,,22.0,3.0,13.0,44.0,16.0,1.0,12.0,6.0,16.0,0.0,1.0,87.0,2.0,0.0,16.0,2.0,,2.0,134.0,0.0,13.0,6.0,4.0,8.0,2.0,,0.0,1.0,0.0,3.0,3.0,0.0,0.0,27.0,1.0,2.0,6.0,27.0,0.0,24.0,0.0,4.0,3.0,2.0,61.0,6.0,4.0,0.0,28.0,0.0,0.0,123.0,0.0,4.0,,,14.0,,2.0,,,1.0,1.0,3.0,1.0,3.0,3.0,13.0,78.0,2.0,0.0,16.0,15.0,50.0,2.0,1.0,3.0,2.0,,9.0,0.0,1.0,50.0,295.0,,139.0,5.0,0.0,1.0,0.0,1.0,1.0,,0.0,2.0,2.0,0.0,4.0,1.0,,5.0,0.0
2024-12-10 00:00:00+00:00,202.0,254.0,105.0,37.0,48.0,784.0,15.0,42.0,39.0,2.0,103.0,2.0,7.0,8.0,1.0,24.0,18.0,13.0,4.0,0.0,0.0,4.0,6.0,11.0,4.0,0.0,4.0,,4.0,1.0,5.0,,,5.0,6.0,11.0,13.0,10.0,1.0,7.0,9.0,17.0,1.0,28.0,87.0,1.0,2.0,22.0,4.0,,1.0,189.0,2.0,20.0,3.0,2.0,2.0,2.0,,0.0,0.0,1.0,5.0,7.0,4.0,1.0,19.0,3.0,1.0,8.0,13.0,0.0,16.0,0.0,10.0,5.0,2.0,48.0,11.0,2.0,4.0,15.0,0.0,0.0,99.0,1.0,2.0,,,20.0,,1.0,,,2.0,4.0,5.0,0.0,3.0,0.0,2.0,61.0,2.0,0.0,14.0,20.0,65.0,2.0,3.0,5.0,1.0,,9.0,0.0,1.0,66.0,271.0,,165.0,3.0,0.0,3.0,0.0,1.0,0.0,,1.0,3.0,8.0,0.0,2.0,0.0,,2.0,0.0
2024-12-11 00:00:00+00:00,256.0,277.0,129.0,49.0,49.0,1013.0,21.0,36.0,19.0,1.0,90.0,0.0,2.0,5.0,3.0,15.0,17.0,10.0,5.0,2.0,0.0,1.0,89.0,50.0,3.0,0.0,9.0,,14.0,1.0,10.0,,,4.0,4.0,17.0,7.0,16.0,2.0,17.0,2.0,26.0,0.0,14.0,109.0,14.0,2.0,25.0,3.0,,5.0,168.0,0.0,9.0,2.0,3.0,5.0,4.0,,0.0,0.0,0.0,2.0,21.0,6.0,0.0,29.0,7.0,0.0,10.0,10.0,1.0,27.0,1.0,9.0,2.0,2.0,56.0,6.0,1.0,2.0,12.0,0.0,0.0,119.0,0.0,8.0,,,22.0,,6.0,,,1.0,5.0,5.0,0.0,3.0,2.0,3.0,129.0,2.0,3.0,28.0,13.0,119.0,2.0,4.0,4.0,0.0,,3.0,0.0,1.0,58.0,254.0,,156.0,0.0,0.0,0.0,0.0,0.0,0.0,,0.0,4.0,8.0,1.0,8.0,1.0,,5.0,0.0
2024-12-12 00:00:00+00:00,325.0,360.0,160.0,162.0,32.0,967.0,25.0,59.0,28.0,25.0,42.0,0.0,7.0,8.0,1.0,28.0,20.0,9.0,6.0,0.0,0.0,3.0,131.0,44.0,7.0,1.0,8.0,,19.0,1.0,6.0,,,4.0,3.0,7.0,18.0,40.0,11.0,13.0,4.0,24.0,0.0,9.0,109.0,23.0,4.0,25.0,1.0,,1.0,123.0,0.0,21.0,4.0,35.0,8.0,1.0,,1.0,4.0,1.0,5.0,10.0,4.0,2.0,31.0,2.0,0.0,5.0,9.0,0.0,20.0,4.0,5.0,3.0,0.0,79.0,10.0,1.0,1.0,40.0,0.0,0.0,138.0,0.0,3.0,,,15.0,,2.0,,,4.0,7.0,1.0,2.0,3.0,4.0,3.0,83.0,1.0,2.0,38.0,19.0,88.0,7.0,5.0,1.0,8.0,,16.0,0.0,1.0,70.0,245.0,,187.0,2.0,0.0,4.0,0.0,1.0,0.0,,0.0,1.0,5.0,1.0,13.0,0.0,,5.0,0.0
2024-12-13 00:00:00+00:00,240.0,310.0,92.0,85.0,48.0,836.0,17.0,39.0,32.0,29.0,35.0,1.0,15.0,9.0,0.0,26.0,16.0,11.0,13.0,2.0,2.0,3.0,150.0,21.0,3.0,0.0,3.0,,11.0,2.0,3.0,,,1.0,17.0,3.0,10.0,49.0,7.0,4.0,4.0,18.0,0.0,13.0,80.0,6.0,6.0,28.0,4.0,,3.0,244.0,0.0,7.0,0.0,5.0,11.0,2.0,,0.0,0.0,1.0,4.0,2.0,1.0,3.0,32.0,0.0,1.0,4.0,11.0,0.0,19.0,1.0,1.0,4.0,1.0,61.0,4.0,2.0,0.0,20.0,0.0,0.0,101.0,0.0,2.0,,,20.0,,4.0,,,1.0,2.0,0.0,2.0,7.0,0.0,8.0,70.0,1.0,5.0,37.0,10.0,136.0,2.0,0.0,0.0,1.0,,9.0,0.0,0.0,47.0,226.0,,149.0,1.0,1.0,0.0,0.0,0.0,1.0,,0.0,0.0,6.0,0.0,5.0,0.0,,8.0,0.0
2024-12-14 00:00:00+00:00,168.0,327.0,92.0,45.0,41.0,881.0,13.0,36.0,21.0,4.0,37.0,0.0,7.0,5.0,0.0,7.0,20.0,11.0,6.0,1.0,0.0,6.0,7.0,16.0,1.0,0.0,2.0,,11.0,2.0,2.0,,,4.0,12.0,4.0,10.0,18.0,4.0,6.0,7.0,14.0,0.0,15.0,58.0,2.0,0.0,17.0,4.0,,0.0,158.0,0.0,18.0,4.0,2.0,7.0,5.0,,0.0,0.0,0.0,4.0,1.0,3.0,4.0,26.0,1.0,1.0,1.0,11.0,1.0,12.0,0.0,6.0,3.0,0.0,55.0,3.0,0.0,16.0,19.0,0.0,0.0,94.0,0.0,7.0,,,17.0,,3.0,,,0.0,1.0,1.0,1.0,1.0,0.0,1.0,56.0,0.0,0.0,11.0,10.0,68.0,3.0,4.0,1.0,2.0,,4.0,0.0,1.0,39.0,204.0,,158.0,0.0,0.0,4.0,0.0,0.0,0.0,,0.0,2.0,1.0,0.0,3.0,7.0,,1.0,0.0
2024-12-15 00:00:00+00:00,173.0,327.0,100.0,42.0,44.0,709.0,68.0,35.0,31.0,3.0,52.0,0.0,9.0,4.0,1.0,10.0,16.0,9.0,3.0,0.0,0.0,2.0,4.0,15.0,4.0,0.0,4.0,,8.0,1.0,3.0,,,5.0,10.0,3.0,4.0,29.0,4.0,10.0,4.0,19.0,0.0,7.0,64.0,2.0,3.0,26.0,3.0,,1.0,129.0,0.0,17.0,15.0,6.0,9.0,3.0,,0.0,0.0,1.0,2.0,1.0,5.0,0.0,24.0,3.0,0.0,4.0,9.0,1.0,19.0,0.0,4.0,3.0,5.0,66.0,20.0,2.0,1.0,55.0,0.0,0.0,117.0,1.0,1.0,,,22.0,,2.0,,,0.0,0.0,2.0,0.0,6.0,2.0,6.0,98.0,0.0,0.0,17.0,10.0,87.0,2.0,0.0,4.0,2.0,,10.0,0.0,0.0,35.0,214.0,,128.0,0.0,1.0,2.0,0.0,0.0,0.0,,0.0,1.0,1.0,0.0,4.0,2.0,,5.0,0.0
2024-12-16 00:00:00+00:00,282.0,445.0,98.0,64.0,127.0,908.0,87.0,37.0,37.0,5.0,64.0,1.0,15.0,5.0,6.0,30.0,23.0,8.0,10.0,3.0,0.0,0.0,3.0,20.0,4.0,0.0,6.0,,9.0,0.0,4.0,,,10.0,3.0,7.0,9.0,54.0,6.0,13.0,4.0,22.0,2.0,6.0,113.0,5.0,1.0,20.0,7.0,,3.0,290.0,0.0,14.0,4.0,6.0,4.0,3.0,,0.0,0.0,0.0,2.0,6.0,3.0,3.0,41.0,2.0,4.0,10.0,8.0,5.0,18.0,3.0,5.0,3.0,2.0,64.0,18.0,0.0,5.0,26.0,0.0,0.0,102.0,0.0,7.0,,,25.0,,6.0,2.0,,0.0,2.0,2.0,1.0,4.0,7.0,5.0,62.0,0.0,1.0,25.0,10.0,99.0,5.0,2.0,4.0,5.0,,8.0,0.0,0.0,59.0,255.0,,178.0,1.0,1.0,1.0,0.0,0.0,0.0,,0.0,4.0,4.0,0.0,10.0,0.0,,1.0,0.0
2024-12-17 00:00:00+00:00,224.0,391.0,74.0,52.0,54.0,1025.0,50.0,45.0,25.0,8.0,46.0,3.0,10.0,13.0,10.0,18.0,17.0,15.0,9.0,2.0,0.0,4.0,5.0,14.0,4.0,1.0,3.0,,8.0,2.0,4.0,,,5.0,3.0,2.0,4.0,43.0,3.0,11.0,5.0,20.0,1.0,6.0,107.0,7.0,1.0,31.0,1.0,,6.0,140.0,0.0,20.0,6.0,10.0,1.0,1.0,,0.0,0.0,0.0,3.0,2.0,6.0,1.0,43.0,1.0,0.0,8.0,15.0,0.0,20.0,5.0,2.0,3.0,1.0,72.0,24.0,1.0,7.0,12.0,0.0,0.0,124.0,0.0,2.0,,,30.0,,3.0,0.0,,0.0,2.0,2.0,0.0,5.0,1.0,6.0,55.0,1.0,1.0,44.0,7.0,66.0,2.0,5.0,5.0,1.0,,5.0,0.0,0.0,56.0,237.0,,164.0,1.0,0.0,1.0,0.0,0.0,1.0,,0.0,7.0,5.0,0.0,4.0,0.0,,5.0,0.0
2024-12-18 00:00:00+00:00,184.0,297.0,71.0,69.0,48.0,938.0,48.0,334.0,28.0,5.0,41.0,2.0,8.0,10.0,8.0,21.0,11.0,6.0,17.0,1.0,0.0,2.0,5.0,28.0,1.0,0.0,4.0,,12.0,3.0,7.0,,,10.0,7.0,4.0,3.0,35.0,4.0,5.0,1.0,19.0,1.0,14.0,156.0,2.0,4.0,20.0,4.0,,1.0,127.0,1.0,13.0,3.0,11.0,2.0,1.0,,0.0,1.0,1.0,5.0,4.0,1.0,1.0,18.0,0.0,0.0,9.0,6.0,0.0,13.0,0.0,2.0,5.0,2.0,69.0,13.0,5.0,2.0,25.0,0.0,0.0,136.0,0.0,1.0,,,26.0,,1.0,0.0,,4.0,4.0,0.0,0.0,4.0,8.0,4.0,82.0,2.0,0.0,41.0,5.0,94.0,3.0,4.0,6.0,4.0,,6.0,0.0,1.0,33.0,258.0,,164.0,1.0,2.0,4.0,0.0,1.0,0.0,,0.0,3.0,2.0,0.0,8.0,2.0,,0.0,0.0
2024-12-19 00:00:00+00:00,165.0,254.0,77.0,45.0,34.0,662.0,48.0,51.0,40.0,6.0,43.0,5.0,2.0,3.0,6.0,25.0,7.0,5.0,9.0,2.0,0.0,3.0,3.0,13.0,3.0,0.0,3.0,,7.0,2.0,6.0,,,10.0,5.0,3.0,12.0,30.0,0.0,6.0,5.0,30.0,0.0,9.0,145.0,5.0,2.0,28.0,3.0,,0.0,103.0,0.0,10.0,6.0,2.0,1.0,3.0,,0.0,2.0,4.0,3.0,1.0,4.0,0.0,44.0,3.0,1.0,4.0,5.0,0.0,14.0,1.0,2.0,2.0,2.0,68.0,4.0,1.0,3.0,22.0,0.0,0.0,165.0,0.0,1.0,,,18.0,,0.0,0.0,,0.0,1.0,1.0,0.0,2.0,2.0,1.0,60.0,0.0,1.0,21.0,13.0,47.0,1.0,1.0,3.0,2.0,,2.0,0.0,2.0,43.0,279.0,,126.0,1.0,1.0,1.0,0.0,0.0,0.0,,0.0,2.0,13.0,0.0,16.0,1.0,,1.0,0.0
2024-12-20 00:00:00+00:00,144.0,335.0,69.0,30.0,51.0,883.0,43.0,35.0,29.0,8.0,40.0,5.0,11.0,3.0,3.0,50.0,15.0,7.0,6.0,4.0,0.0,3.0,2.0,22.0,6.0,1.0,38.0,,22.0,3.0,5.0,,,8.0,0.0,5.0,5.0,70.0,2.0,46.0,5.0,15.0,0.0,5.0,125.0,1.0,0.0,29.0,3.0,,1.0,116.0,0.0,18.0,12.0,4.0,7.0,1.0,,1.0,0.0,2.0,3.0,2.0,0.0,1.0,32.0,1.0,0.0,9.0,7.0,4.0,13.0,3.0,3.0,5.0,0.0,90.0,3.0,2.0,1.0,15.0,0.0,0.0,144.0,0.0,2.0,,,32.0,,2.0,0.0,,1.0,1.0,4.0,0.0,4.0,0.0,3.0,58.0,2.0,0.0,35.0,11.0,57.0,1.0,5.0,1.0,1.0,,3.0,0.0,3.0,43.0,295.0,,139.0,0.0,0.0,4.0,0.0,0.0,0.0,,0.0,3.0,4.0,0.0,9.0,0.0,,0.0,1.0
2024-12-21 00:00:00+00:00,110.0,301.0,71.0,31.0,46.0,555.0,57.0,29.0,15.0,7.0,34.0,4.0,3.0,5.0,5.0,14.0,21.0,4.0,5.0,1.0,0.0,1.0,9.0,33.0,0.0,0.0,1.0,,7.0,1.0,0.0,,,1.0,1.0,4.0,6.0,35.0,4.0,2.0,4.0,13.0,0.0,2.0,80.0,1.0,1.0,11.0,2.0,,3.0,77.0,1.0,9.0,4.0,1.0,4.0,0.0,,0.0,0.0,1.0,2.0,2.0,1.0,0.0,19.0,0.0,0.0,9.0,4.0,1.0,13.0,2.0,1.0,2.0,4.0,71.0,8.0,0.0,2.0,20.0,0.0,0.0,103.0,0.0,6.0,,,19.0,,2.0,0.0,,0.0,2.0,1.0,1.0,9.0,0.0,5.0,63.0,1.0,2.0,14.0,8.0,41.0,1.0,9.0,6.0,1.0,,5.0,0.0,1.0,55.0,271.0,,91.0,1.0,0.0,2.0,0.0,1.0,1.0,,0.0,3.0,2.0,0.0,7.0,0.0,,3.0,0.0
2024-12-22 00:00:00+00:00,96.0,237.0,82.0,29.0,45.0,737.0,30.0,25.0,17.0,6.0,20.0,2.0,2.0,8.0,4.0,19.0,10.0,4.0,2.0,0.0,0.0,1.0,5.0,16.0,2.0,0.0,4.0,,8.0,0.0,2.0,,,6.0,3.0,2.0,10.0,20.0,3.0,5.0,2.0,15.0,0.0,3.0,95.0,5.0,0.0,14.0,2.0,,0.0,67.0,1.0,12.0,2.0,1.0,8.0,2.0,,0.0,0.0,0.0,0.0,10.0,0.0,2.0,17.0,0.0,0.0,4.0,4.0,1.0,12.0,1.0,0.0,0.0,0.0,71.0,16.0,2.0,5.0,28.0,0.0,0.0,76.0,0.0,1.0,,,11.0,,1.0,0.0,,1.0,1.0,0.0,0.0,0.0,0.0,2.0,52.0,0.0,0.0,16.0,5.0,41.0,2.0,3.0,1.0,2.0,,3.0,0.0,0.0,38.0,314.0,,103.0,0.0,1.0,2.0,0.0,0.0,0.0,,0.0,0.0,0.0,2.0,11.0,0.0,,2.0,0.0
2024-12-23 00:00:00+00:00,139.0,410.0,97.0,78.0,32.0,758.0,40.0,28.0,13.0,4.0,36.0,13.0,8.0,4.0,5.0,15.0,8.0,7.0,9.0,3.0,0.0,0.0,7.0,71.0,9.0,0.0,7.0,,42.0,1.0,0.0,,,6.0,0.0,2.0,5.0,13.0,0.0,4.0,5.0,13.0,1.0,6.0,96.0,4.0,1.0,21.0,4.0,,3.0,82.0,1.0,12.0,3.0,1.0,2.0,0.0,,0.0,0.0,1.0,0.0,14.0,3.0,2.0,34.0,0.0,0.0,5.0,7.0,1.0,24.0,1.0,1.0,2.0,1.0,65.0,18.0,0.0,1.0,47.0,0.0,0.0,112.0,0.0,4.0,,,40.0,,3.0,0.0,,0.0,1.0,0.0,2.0,1.0,0.0,4.0,54.0,0.0,0.0,11.0,15.0,56.0,1.0,5.0,7.0,1.0,,2.0,0.0,1.0,46.0,265.0,,121.0,2.0,1.0,0.0,0.0,2.0,0.0,,0.0,0.0,1.0,0.0,4.0,0.0,,2.0,0.0
2024-12-24 00:00:00+00:00,153.0,267.0,86.0,56.0,29.0,743.0,16.0,21.0,25.0,6.0,53.0,20.0,3.0,5.0,2.0,15.0,10.0,7.0,8.0,1.0,0.0,1.0,6.0,14.0,8.0,0.0,11.0,,8.0,2.0,3.0,,,0.0,4.0,1.0,10.0,15.0,0.0,7.0,8.0,15.0,1.0,12.0,112.0,2.0,1.0,19.0,5.0,,0.0,89.0,0.0,13.0,1.0,3.0,4.0,2.0,,2.0,0.0,1.0,0.0,7.0,0.0,2.0,30.0,0.0,0.0,7.0,7.0,0.0,19.0,0.0,0.0,5.0,4.0,59.0,15.0,0.0,2.0,15.0,0.0,0.0,109.0,0.0,2.0,,,17.0,,5.0,2.0,,2.0,1.0,3.0,1.0,3.0,2.0,0.0,61.0,1.0,0.0,16.0,7.0,54.0,1.0,2.0,8.0,1.0,,1.0,0.0,0.0,40.0,166.0,,133.0,2.0,0.0,2.0,0.0,1.0,0.0,,0.0,0.0,2.0,0.0,12.0,0.0,,0.0,0.0
2024-12-25 00:00:00+00:00,110.0,210.0,59.0,43.0,15.0,503.0,14.0,25.0,19.0,3.0,29.0,4.0,8.0,4.0,1.0,16.0,5.0,3.0,1.0,0.0,1.0,1.0,8.0,25.0,3.0,0.0,6.0,,24.0,19.0,7.0,,,8.0,0.0,1.0,2.0,60.0,0.0,7.0,3.0,11.0,0.0,2.0,74.0,2.0,1.0,13.0,1.0,,0.0,72.0,1.0,8.0,1.0,7.0,3.0,7.0,,0.0,0.0,1.0,1.0,11.0,1.0,2.0,19.0,1.0,1.0,3.0,3.0,0.0,14.0,1.0,0.0,2.0,0.0,61.0,12.0,1.0,3.0,17.0,0.0,0.0,69.0,0.0,2.0,,,16.0,,2.0,0.0,,2.0,3.0,0.0,0.0,2.0,4.0,4.0,66.0,0.0,0.0,19.0,5.0,67.0,3.0,4.0,6.0,0.0,,1.0,0.0,5.0,47.0,196.0,,100.0,0.0,0.0,2.0,0.0,1.0,0.0,,1.0,6.0,2.0,1.0,10.0,1.0,,1.0,0.0
2024-12-26 00:00:00+00:00,122.0,243.0,62.0,36.0,24.0,549.0,10.0,26.0,20.0,2.0,31.0,0.0,3.0,3.0,5.0,15.0,9.0,6.0,8.0,0.0,0.0,2.0,2.0,16.0,4.0,0.0,3.0,,8.0,10.0,1.0,,,5.0,0.0,2.0,5.0,25.0,0.0,7.0,6.0,15.0,0.0,1.0,53.0,0.0,0.0,14.0,1.0,,1.0,88.0,0.0,14.0,5.0,0.0,16.0,6.0,,0.0,0.0,0.0,0.0,1.0,3.0,1.0,19.0,0.0,0.0,7.0,6.0,0.0,15.0,1.0,1.0,2.0,1.0,76.0,12.0,2.0,7.0,2.0,0.0,0.0,84.0,0.0,2.0,,,18.0,,2.0,0.0,,0.0,2.0,1.0,1.0,2.0,2.0,3.0,38.0,0.0,1.0,11.0,4.0,51.0,3.0,1.0,5.0,2.0,,2.0,0.0,3.0,32.0,163.0,,101.0,0.0,0.0,0.0,0.0,0.0,0.0,,0.0,2.0,1.0,0.0,7.0,0.0,,5.0,0.0
2024-12-27 00:00:00+00:00,92.0,234.0,61.0,33.0,14.0,1058.0,13.0,39.0,13.0,8.0,38.0,4.0,1.0,4.0,3.0,17.0,12.0,7.0,5.0,0.0,1.0,0.0,8.0,24.0,2.0,1.0,3.0,,19.0,0.0,3.0,,,7.0,3.0,1.0,3.0,11.0,0.0,9.0,5.0,11.0,0.0,1.0,86.0,4.0,0.0,16.0,3.0,,1.0,199.0,0.0,13.0,2.0,2.0,14.0,3.0,,0.0,0.0,4.0,0.0,1.0,2.0,3.0,30.0,1.0,1.0,3.0,6.0,0.0,15.0,0.0,0.0,3.0,1.0,61.0,10.0,0.0,3.0,1.0,0.0,0.0,53.0,0.0,2.0,,,25.0,,1.0,0.0,,3.0,0.0,1.0,1.0,4.0,1.0,2.0,46.0,0.0,0.0,11.0,5.0,39.0,3.0,2.0,1.0,1.0,,8.0,0.0,0.0,31.0,207.0,,115.0,0.0,1.0,3.0,0.0,0.0,0.0,,1.0,3.0,1.0,2.0,5.0,0.0,,1.0,0.0
2024-12-28 00:00:00+00:00,87.0,214.0,94.0,23.0,20.0,970.0,19.0,37.0,14.0,3.0,23.0,7.0,4.0,9.0,6.0,20.0,7.0,3.0,6.0,1.0,1.0,1.0,1.0,14.0,6.0,0.0,4.0,,5.0,2.0,2.0,,,7.0,2.0,4.0,4.0,28.0,3.0,2.0,11.0,16.0,0.0,3.0,59.0,3.0,2.0,12.0,1.0,,0.0,92.0,1.0,11.0,2.0,1.0,24.0,2.0,,0.0,0.0,2.0,0.0,0.0,2.0,3.0,30.0,0.0,3.0,6.0,3.0,0.0,9.0,1.0,2.0,3.0,2.0,117.0,18.0,1.0,3.0,1.0,0.0,0.0,144.0,0.0,0.0,,,11.0,,1.0,0.0,,0.0,2.0,2.0,2.0,1.0,2.0,8.0,47.0,0.0,2.0,20.0,3.0,66.0,0.0,2.0,3.0,0.0,,5.0,0.0,0.0,76.0,160.0,,114.0,0.0,0.0,2.0,0.0,0.0,0.0,,0.0,2.0,3.0,0.0,1.0,0.0,,2.0,0.0
2024-12-29 00:00:00+00:00,105.0,212.0,67.0,42.0,17.0,708.0,13.0,17.0,18.0,3.0,43.0,3.0,7.0,5.0,2.0,15.0,17.0,5.0,1.0,0.0,0.0,3.0,3.0,8.0,7.0,0.0,6.0,,5.0,3.0,0.0,,,5.0,3.0,22.0,2.0,18.0,1.0,11.0,5.0,18.0,0.0,3.0,66.0,2.0,1.0,9.0,0.0,,2.0,79.0,0.0,14.0,4.0,1.0,9.0,3.0,,0.0,0.0,0.0,0.0,4.0,1.0,4.0,18.0,0.0,2.0,3.0,5.0,0.0,12.0,0.0,4.0,3.0,2.0,91.0,6.0,2.0,1.0,2.0,0.0,0.0,135.0,0.0,1.0,,,12.0,,1.0,1.0,,1.0,1.0,3.0,0.0,4.0,0.0,12.0,37.0,1.0,1.0,7.0,4.0,79.0,1.0,7.0,2.0,1.0,,6.0,0.0,0.0,46.0,198.0,,118.0,1.0,0.0,1.0,0.0,0.0,0.0,,0.0,1.0,6.0,0.0,4.0,0.0,,1.0,0.0
2024-12-30 00:00:00+00:00,123.0,305.0,73.0,15.0,31.0,713.0,60.0,33.0,22.0,8.0,40.0,6.0,10.0,3.0,7.0,14.0,3.0,10.0,12.0,1.0,0.0,2.0,2.0,8.0,9.0,1.0,2.0,,7.0,7.0,3.0,,,8.0,6.0,1.0,4.0,6.0,0.0,5.0,3.0,14.0,1.0,5.0,66.0,4.0,1.0,25.0,1.0,,1.0,165.0,1.0,11.0,5.0,3.0,4.0,1.0,,0.0,0.0,1.0,3.0,1.0,0.0,3.0,26.0,1.0,0.0,4.0,10.0,1.0,17.0,2.0,2.0,2.0,1.0,124.0,9.0,4.0,1.0,7.0,0.0,0.0,144.0,0.0,2.0,,,20.0,,1.0,1.0,,1.0,0.0,2.0,0.0,2.0,2.0,3.0,66.0,1.0,0.0,22.0,11.0,86.0,1.0,2.0,3.0,0.0,,4.0,1.0,0.0,34.0,188.0,,144.0,1.0,0.0,0.0,0.0,1.0,1.0,,0.0,4.0,3.0,0.0,7.0,0.0,,3.0,0.0
2024-12-31 00:00:00+00:00,82.0,222.0,75.0,23.0,22.0,764.0,23.0,28.0,12.0,6.0,39.0,6.0,3.0,4.0,6.0,13.0,6.0,9.0,5.0,1.0,0.0,1.0,8.0,5.0,13.0,1.0,2.0,,3.0,0.0,0.0,,,1.0,2.0,2.0,9.0,17.0,0.0,2.0,8.0,13.0,0.0,4.0,73.0,14.0,0.0,16.0,1.0,,0.0,130.0,0.0,15.0,3.0,16.0,2.0,2.0,,0.0,0.0,1.0,1.0,5.0,2.0,4.0,18.0,0.0,0.0,14.0,9.0,0.0,14.0,1.0,4.0,4.0,1.0,74.0,4.0,2.0,0.0,4.0,0.0,0.0,97.0,0.0,4.0,,,20.0,,0.0,0.0,,0.0,0.0,3.0,2.0,2.0,1.0,3.0,57.0,0.0,0.0,19.0,6.0,205.0,1.0,2.0,3.0,2.0,,3.0,1.0,1.0,39.0,200.0,,123.0,1.0,0.0,0.0,0.0,0.0,0.0,,0.0,1.0,0.0,0.0,6.0,0.0,,3.0,0.0
2025-01-01 00:00:00+00:00,78.0,173.0,63.0,21.0,13.0,637.0,8.0,17.0,16.0,5.0,13.0,3.0,3.0,2.0,6.0,17.0,6.0,3.0,4.0,0.0,0.0,3.0,3.0,17.0,13.0,2.0,2.0,,0.0,0.0,3.0,,,8.0,1.0,2.0,1.0,7.0,2.0,1.0,5.0,15.0,1.0,1.0,60.0,4.0,0.0,21.0,4.0,,0.0,94.0,1.0,7.0,2.0,9.0,4.0,0.0,,0.0,0.0,2.0,0.0,2.0,2.0,4.0,23.0,1.0,1.0,8.0,3.0,0.0,14.0,1.0,1.0,1.0,0.0,50.0,2.0,1.0,0.0,13.0,0.0,0.0,128.0,0.0,4.0,,,6.0,,1.0,1.0,,0.0,1.0,3.0,1.0,3.0,3.0,5.0,49.0,0.0,1.0,24.0,1.0,256.0,11.0,3.0,0.0,1.0,,3.0,0.0,0.0,51.0,199.0,,86.0,0.0,0.0,4.0,0.0,0.0,0.0,,1.0,0.0,2.0,0.0,6.0,0.0,,6.0,0.0
2025-01-02 00:00:00+00:00,106.0,270.0,95.0,51.0,25.0,687.0,21.0,26.0,45.0,4.0,68.0,26.0,3.0,5.0,13.0,23.0,11.0,6.0,8.0,3.0,3.0,2.0,7.0,37.0,20.0,1.0,4.0,,11.0,0.0,3.0,,,3.0,1.0,1.0,10.0,11.0,8.0,8.0,5.0,16.0,2.0,6.0,63.0,4.0,3.0,16.0,0.0,,1.0,87.0,2.0,11.0,1.0,1.0,5.0,1.0,,0.0,0.0,1.0,0.0,4.0,4.0,4.0,24.0,0.0,0.0,5.0,6.0,0.0,17.0,0.0,2.0,4.0,0.0,67.0,2.0,2.0,3.0,3.0,0.0,0.0,111.0,0.0,2.0,,,15.0,,0.0,0.0,,0.0,0.0,3.0,2.0,3.0,1.0,6.0,56.0,0.0,1.0,22.0,8.0,212.0,5.0,2.0,2.0,1.0,,6.0,0.0,0.0,41.0,219.0,,135.0,0.0,0.0,0.0,0.0,0.0,0.0,,0.0,0.0,1.0,0.0,20.0,1.0,,0.0,0.0
2025-01-03 00:00:00+00:00,145.0,258.0,76.0,41.0,26.0,688.0,56.0,36.0,34.0,5.0,59.0,12.0,8.0,3.0,8.0,29.0,13.0,7.0,5.0,0.0,0.0,3.0,6.0,16.0,19.0,0.0,0.0,,6.0,2.0,1.0,,,10.0,8.0,3.0,10.0,10.0,4.0,5.0,8.0,17.0,1.0,7.0,75.0,12.0,1.0,23.0,1.0,,1.0,67.0,2.0,14.0,9.0,4.0,3.0,2.0,,0.0,1.0,5.0,0.0,5.0,3.0,6.0,30.0,2.0,1.0,8.0,7.0,1.0,19.0,0.0,0.0,1.0,0.0,108.0,1.0,2.0,2.0,11.0,0.0,0.0,138.0,0.0,2.0,,,30.0,,2.0,0.0,,3.0,0.0,2.0,1.0,4.0,4.0,2.0,61.0,2.0,1.0,18.0,6.0,287.0,1.0,1.0,5.0,1.0,,8.0,0.0,0.0,47.0,192.0,,139.0,1.0,0.0,2.0,0.0,0.0,0.0,,0.0,4.0,4.0,0.0,15.0,1.0,,1.0,0.0
2025-01-04 00:00:00+00:00,117.0,203.0,88.0,22.0,26.0,692.0,40.0,29.0,39.0,2.0,103.0,1.0,5.0,0.0,6.0,22.0,12.0,5.0,3.0,1.0,0.0,4.0,5.0,9.0,9.0,0.0,1.0,,2.0,13.0,1.0,,,6.0,9.0,5.0,13.0,14.0,13.0,9.0,7.0,6.0,0.0,2.0,59.0,7.0,0.0,27.0,1.0,,1.0,63.0,3.0,13.0,0.0,5.0,5.0,1.0,,0.0,0.0,0.0,2.0,1.0,0.0,1.0,21.0,1.0,0.0,6.0,5.0,0.0,19.0,0.0,0.0,2.0,0.0,72.0,4.0,1.0,0.0,10.0,0.0,0.0,83.0,0.0,5.0,,,13.0,,7.0,1.0,,1.0,1.0,2.0,0.0,2.0,2.0,6.0,54.0,0.0,0.0,11.0,8.0,204.0,0.0,2.0,0.0,1.0,,1.0,0.0,0.0,23.0,188.0,,121.0,3.0,0.0,0.0,0.0,0.0,0.0,,0.0,1.0,6.0,0.0,4.0,1.0,,1.0,0.0
2025-01-05 00:00:00+00:00,103.0,196.0,67.0,27.0,16.0,638.0,21.0,30.0,33.0,4.0,113.0,1.0,8.0,0.0,6.0,17.0,10.0,3.0,13.0,0.0,0.0,1.0,3.0,7.0,7.0,1.0,5.0,,9.0,12.0,3.0,,,8.0,9.0,4.0,9.0,5.0,8.0,10.0,2.0,12.0,1.0,2.0,61.0,2.0,1.0,19.0,1.0,,1.0,98.0,2.0,17.0,1.0,1.0,10.0,1.0,,1.0,1.0,0.0,2.0,3.0,1.0,2.0,20.0,2.0,1.0,7.0,3.0,0.0,23.0,1.0,3.0,1.0,1.0,88.0,13.0,0.0,0.0,17.0,0.0,0.0,125.0,0.0,6.0,,,13.0,,1.0,3.0,,0.0,2.0,0.0,0.0,2.0,1.0,3.0,52.0,0.0,1.0,13.0,6.0,303.0,2.0,3.0,2.0,1.0,,2.0,1.0,0.0,65.0,198.0,,127.0,0.0,0.0,3.0,0.0,1.0,0.0,,0.0,6.0,3.0,0.0,35.0,0.0,,1.0,0.0
2025-01-06 00:00:00+00:00,88.0,251.0,53.0,32.0,29.0,833.0,35.0,37.0,86.0,6.0,59.0,3.0,10.0,5.0,6.0,18.0,13.0,5.0,15.0,6.0,0.0,1.0,1.0,10.0,6.0,0.0,7.0,,8.0,3.0,2.0,,,22.0,12.0,11.0,6.0,13.0,0.0,8.0,6.0,19.0,1.0,5.0,51.0,6.0,1.0,20.0,1.0,,0.0,85.0,1.0,19.0,3.0,1.0,5.0,1.0,,0.0,0.0,0.0,3.0,4.0,9.0,2.0,37.0,1.0,0.0,3.0,5.0,1.0,15.0,1.0,1.0,3.0,0.0,60.0,20.0,2.0,1.0,12.0,0.0,0.0,127.0,0.0,3.0,,,11.0,,1.0,2.0,,0.0,1.0,1.0,5.0,3.0,4.0,1.0,54.0,1.0,0.0,9.0,8.0,305.0,3.0,2.0,4.0,0.0,,3.0,0.0,1.0,54.0,215.0,,114.0,0.0,0.0,1.0,0.0,2.0,1.0,,0.0,4.0,4.0,0.0,12.0,0.0,,2.0,0.0
2025-01-07 00:00:00+00:00,295.0,235.0,42.0,21.0,17.0,899.0,20.0,26.0,37.0,3.0,158.0,7.0,1.0,3.0,3.0,10.0,6.0,14.0,7.0,4.0,0.0,0.0,6.0,17.0,9.0,0.0,1.0,,12.0,1.0,1.0,,,13.0,3.0,2.0,20.0,8.0,2.0,5.0,5.0,37.0,3.0,5.0,92.0,3.0,0.0,19.0,3.0,,1.0,112.0,1.0,11.0,2.0,4.0,1.0,1.0,,2.0,0.0,0.0,1.0,4.0,11.0,0.0,20.0,4.0,0.0,9.0,14.0,0.0,16.0,0.0,7.0,3.0,2.0,55.0,13.0,1.0,3.0,17.0,0.0,0.0,134.0,0.0,3.0,,,23.0,,0.0,2.0,,2.0,0.0,0.0,2.0,3.0,4.0,0.0,61.0,2.0,3.0,21.0,12.0,215.0,2.0,2.0,2.0,1.0,,2.0,0.0,4.0,55.0,192.0,,140.0,1.0,0.0,1.0,0.0,0.0,1.0,,0.0,2.0,3.0,0.0,4.0,0.0,,1.0,0.0
2025-01-08 00:00:00+00:00,243.0,271.0,48.0,23.0,20.0,755.0,20.0,30.0,23.0,5.0,109.0,6.0,21.0,5.0,6.0,19.0,13.0,5.0,4.0,3.0,0.0,1.0,2.0,20.0,12.0,1.0,7.0,,9.0,1.0,4.0,,,7.0,3.0,0.0,9.0,15.0,5.0,3.0,3.0,28.0,0.0,4.0,58.0,1.0,1.0,17.0,1.0,,1.0,163.0,1.0,12.0,0.0,0.0,6.0,0.0,,0.0,1.0,1.0,1.0,2.0,9.0,11.0,19.0,1.0,0.0,11.0,4.0,1.0,21.0,1.0,1.0,4.0,1.0,75.0,8.0,3.0,0.0,11.0,0.0,0.0,113.0,0.0,3.0,,,16.0,,1.0,0.0,,0.0,1.0,4.0,3.0,2.0,0.0,1.0,52.0,1.0,1.0,20.0,12.0,185.0,2.0,1.0,3.0,3.0,,0.0,2.0,1.0,28.0,243.0,,126.0,1.0,0.0,1.0,0.0,0.0,1.0,,0.0,1.0,6.0,1.0,8.0,0.0,,3.0,0.0
2025-01-09 00:00:00+00:00,137.0,228.0,40.0,26.0,13.0,768.0,15.0,28.0,29.0,5.0,113.0,3.0,8.0,1.0,5.0,34.0,7.0,6.0,5.0,2.0,0.0,9.0,2.0,6.0,13.0,2.0,10.0,,5.0,0.0,1.0,,,3.0,2.0,5.0,5.0,16.0,2.0,3.0,5.0,36.0,0.0,1.0,58.0,5.0,4.0,19.0,1.0,,3.0,96.0,1.0,12.0,1.0,3.0,3.0,3.0,,0.0,0.0,1.0,0.0,3.0,1.0,8.0,18.0,1.0,0.0,5.0,6.0,0.0,11.0,0.0,1.0,5.0,0.0,54.0,1.0,2.0,2.0,5.0,0.0,0.0,83.0,0.0,7.0,,,22.0,,1.0,0.0,,1.0,9.0,4.0,2.0,2.0,3.0,5.0,69.0,2.0,0.0,23.0,11.0,163.0,4.0,2.0,3.0,1.0,,2.0,0.0,0.0,40.0,258.0,,140.0,1.0,0.0,1.0,0.0,0.0,0.0,,0.0,0.0,4.0,0.0,11.0,1.0,,1.0,0.0
2025-01-10 00:00:00+00:00,111.0,212.0,133.0,20.0,28.0,687.0,27.0,38.0,47.0,3.0,84.0,2.0,9.0,12.0,11.0,52.0,7.0,15.0,26.0,2.0,0.0,2.0,4.0,10.0,5.0,0.0,2.0,,7.0,1.0,10.0,,,14.0,2.0,2.0,4.0,14.0,6.0,3.0,2.0,16.0,0.0,6.0,159.0,0.0,0.0,20.0,3.0,,0.0,62.0,1.0,14.0,4.0,2.0,7.0,4.0,,0.0,1.0,2.0,3.0,3.0,3.0,0.0,20.0,1.0,1.0,8.0,15.0,0.0,14.0,1.0,7.0,2.0,6.0,51.0,0.0,3.0,0.0,6.0,0.0,0.0,101.0,0.0,10.0,,,18.0,,2.0,0.0,,1.0,4.0,1.0,1.0,3.0,2.0,3.0,61.0,0.0,2.0,18.0,5.0,74.0,1.0,5.0,2.0,5.0,,2.0,0.0,1.0,35.0,200.0,,120.0,3.0,1.0,2.0,0.0,2.0,0.0,,0.0,1.0,8.0,1.0,5.0,0.0,,2.0,0.0
2025-01-11 00:00:00+00:00,111.0,178.0,56.0,23.0,18.0,841.0,9.0,24.0,22.0,5.0,122.0,7.0,5.0,6.0,4.0,29.0,3.0,6.0,10.0,1.0,0.0,5.0,4.0,8.0,15.0,0.0,0.0,,5.0,1.0,0.0,,,12.0,1.0,1.0,3.0,14.0,2.0,1.0,4.0,9.0,0.0,2.0,193.0,4.0,1.0,25.0,1.0,,0.0,65.0,1.0,17.0,1.0,0.0,6.0,0.0,,1.0,1.0,0.0,1.0,2.0,1.0,1.0,32.0,0.0,0.0,5.0,6.0,1.0,16.0,3.0,2.0,1.0,1.0,55.0,1.0,2.0,0.0,7.0,0.0,0.0,110.0,0.0,15.0,,,15.0,,0.0,1.0,,1.0,4.0,0.0,1.0,2.0,2.0,5.0,58.0,0.0,0.0,13.0,6.0,28.0,1.0,1.0,2.0,3.0,,6.0,1.0,0.0,43.0,167.0,,111.0,1.0,0.0,1.0,0.0,0.0,3.0,,0.0,1.0,1.0,0.0,4.0,1.0,,1.0,0.0
2025-01-12 00:00:00+00:00,123.0,154.0,46.0,16.0,26.0,875.0,9.0,22.0,18.0,3.0,146.0,3.0,5.0,3.0,2.0,24.0,3.0,2.0,17.0,1.0,0.0,0.0,1.0,7.0,2.0,0.0,0.0,,8.0,6.0,1.0,,,2.0,3.0,1.0,3.0,6.0,2.0,7.0,4.0,9.0,0.0,0.0,205.0,2.0,0.0,24.0,2.0,,1.0,61.0,0.0,14.0,2.0,2.0,4.0,2.0,,1.0,0.0,0.0,0.0,3.0,6.0,1.0,20.0,0.0,0.0,8.0,2.0,0.0,6.0,0.0,1.0,6.0,1.0,73.0,6.0,5.0,0.0,6.0,0.0,0.0,101.0,0.0,10.0,,,17.0,,0.0,0.0,,0.0,0.0,5.0,1.0,0.0,5.0,4.0,38.0,0.0,1.0,6.0,3.0,42.0,2.0,1.0,2.0,2.0,,2.0,9.0,0.0,34.0,181.0,,126.0,1.0,0.0,2.0,0.0,0.0,0.0,,0.0,2.0,0.0,0.0,7.0,0.0,,0.0,0.0
2025-01-13 00:00:00+00:00,147.0,196.0,49.0,34.0,26.0,587.0,22.0,28.0,27.0,3.0,52.0,1.0,12.0,2.0,4.0,18.0,12.0,11.0,14.0,4.0,0.0,1.0,9.0,6.0,33.0,0.0,4.0,,9.0,2.0,0.0,,,8.0,2.0,1.0,3.0,10.0,2.0,4.0,9.0,27.0,0.0,9.0,177.0,3.0,0.0,31.0,5.0,,0.0,55.0,0.0,14.0,1.0,1.0,2.0,5.0,,1.0,0.0,0.0,4.0,1.0,0.0,0.0,50.0,1.0,1.0,4.0,11.0,0.0,16.0,1.0,2.0,6.0,3.0,53.0,6.0,6.0,1.0,20.0,0.0,0.0,184.0,0.0,2.0,,,4.0,,1.0,0.0,,1.0,0.0,1.0,0.0,3.0,3.0,5.0,44.0,1.0,2.0,16.0,7.0,47.0,1.0,1.0,2.0,4.0,,4.0,6.0,1.0,42.0,199.0,,122.0,0.0,0.0,1.0,0.0,0.0,0.0,,0.0,2.0,5.0,0.0,9.0,0.0,,1.0,0.0
2025-01-14 00:00:00+00:00,118.0,192.0,69.0,18.0,33.0,729.0,14.0,31.0,23.0,22.0,81.0,1.0,8.0,6.0,4.0,31.0,13.0,4.0,1.0,2.0,0.0,0.0,0.0,11.0,15.0,0.0,6.0,,0.0,0.0,9.0,,,4.0,9.0,2.0,2.0,14.0,4.0,2.0,2.0,22.0,1.0,5.0,100.0,1.0,0.0,23.0,2.0,,1.0,102.0,1.0,10.0,1.0,2.0,3.0,7.0,,0.0,0.0,0.0,0.0,4.0,2.0,3.0,36.0,0.0,0.0,2.0,4.0,0.0,16.0,0.0,4.0,2.0,2.0,83.0,6.0,1.0,1.0,2.0,0.0,0.0,101.0,0.0,8.0,,,17.0,,1.0,0.0,,0.0,6.0,1.0,1.0,4.0,1.0,8.0,92.0,2.0,0.0,14.0,11.0,48.0,2.0,0.0,2.0,0.0,,0.0,1.0,1.0,42.0,186.0,,108.0,2.0,0.0,1.0,0.0,0.0,0.0,,0.0,0.0,3.0,1.0,5.0,1.0,,0.0,0.0
2025-01-15 00:00:00+00:00,205.0,214.0,82.0,27.0,19.0,764.0,24.0,16.0,32.0,19.0,60.0,11.0,8.0,2.0,4.0,27.0,15.0,1.0,7.0,3.0,0.0,0.0,5.0,8.0,9.0,0.0,7.0,,7.0,1.0,2.0,,13.0,4.0,5.0,2.0,15.0,15.0,1.0,7.0,12.0,18.0,2.0,8.0,101.0,6.0,2.0,24.0,2.0,1.0,1.0,166.0,0.0,13.0,3.0,3.0,3.0,5.0,,1.0,0.0,0.0,2.0,2.0,2.0,3.0,38.0,1.0,0.0,5.0,1.0,0.0,20.0,1.0,3.0,0.0,2.0,75.0,4.0,0.0,1.0,9.0,0.0,0.0,101.0,0.0,5.0,,725.0,12.0,,1.0,0.0,,1.0,0.0,0.0,4.0,2.0,4.0,9.0,118.0,0.0,1.0,49.0,19.0,51.0,3.0,5.0,2.0,2.0,121.0,4.0,0.0,4.0,49.0,210.0,,134.0,0.0,0.0,2.0,0.0,0.0,0.0,2.0,0.0,11.0,10.0,0.0,10.0,0.0,2.0,0.0,0.0
2025-01-16 00:00:00+00:00,192.0,257.0,77.0,29.0,38.0,794.0,47.0,25.0,24.0,8.0,64.0,8.0,11.0,4.0,9.0,28.0,13.0,7.0,51.0,4.0,0.0,4.0,6.0,16.0,14.0,0.0,6.0,,10.0,2.0,1.0,,9.0,10.0,3.0,0.0,10.0,12.0,0.0,5.0,10.0,18.0,2.0,14.0,293.0,4.0,0.0,19.0,0.0,1.0,0.0,114.0,0.0,15.0,2.0,2.0,3.0,3.0,,1.0,1.0,0.0,3.0,0.0,1.0,1.0,47.0,1.0,1.0,8.0,7.0,1.0,14.0,1.0,6.0,1.0,1.0,47.0,4.0,1.0,0.0,4.0,0.0,0.0,131.0,0.0,1.0,,872.0,22.0,,0.0,0.0,,0.0,1.0,3.0,5.0,2.0,0.0,7.0,126.0,1.0,0.0,17.0,19.0,46.0,6.0,1.0,3.0,1.0,147.0,4.0,0.0,1.0,70.0,253.0,,165.0,2.0,0.0,2.0,0.0,0.0,0.0,1.0,0.0,9.0,18.0,0.0,11.0,2.0,4.0,2.0,0.0
2025-01-17 00:00:00+00:00,197.0,265.0,70.0,31.0,36.0,873.0,23.0,25.0,63.0,5.0,61.0,5.0,11.0,10.0,5.0,35.0,18.0,5.0,53.0,2.0,0.0,2.0,5.0,12.0,16.0,0.0,2.0,,4.0,1.0,2.0,,15.0,4.0,0.0,6.0,10.0,12.0,2.0,10.0,25.0,27.0,4.0,8.0,190.0,6.0,1.0,15.0,3.0,0.0,2.0,152.0,2.0,33.0,0.0,1.0,7.0,1.0,,1.0,0.0,1.0,5.0,8.0,1.0,2.0,41.0,0.0,3.0,5.0,5.0,1.0,11.0,0.0,0.0,1.0,1.0,53.0,2.0,7.0,0.0,8.0,0.0,0.0,132.0,0.0,4.0,,846.0,19.0,,0.0,0.0,,2.0,4.0,6.0,1.0,2.0,0.0,4.0,92.0,2.0,2.0,19.0,14.0,46.0,7.0,1.0,4.0,1.0,125.0,2.0,0.0,2.0,32.0,211.0,,155.0,0.0,1.0,1.0,0.0,0.0,0.0,1.0,0.0,3.0,5.0,0.0,11.0,0.0,4.0,1.0,0.0
2025-01-18 00:00:00+00:00,157.0,365.0,62.0,29.0,88.0,889.0,13.0,41.0,31.0,6.0,130.0,3.0,8.0,1.0,6.0,24.0,8.0,3.0,16.0,2.0,0.0,0.0,4.0,10.0,15.0,0.0,5.0,,5.0,2.0,4.0,,33.0,16.0,1.0,5.0,9.0,7.0,2.0,4.0,6.0,25.0,2.0,3.0,134.0,3.0,1.0,22.0,3.0,1.0,1.0,166.0,0.0,39.0,0.0,1.0,7.0,5.0,,1.0,4.0,1.0,1.0,4.0,1.0,0.0,47.0,0.0,2.0,9.0,3.0,0.0,22.0,0.0,1.0,7.0,2.0,51.0,1.0,4.0,0.0,19.0,0.0,0.0,90.0,0.0,2.0,,881.0,17.0,,1.0,0.0,,1.0,0.0,1.0,2.0,3.0,0.0,3.0,158.0,0.0,0.0,19.0,19.0,52.0,2.0,1.0,2.0,0.0,129.0,5.0,1.0,0.0,38.0,274.0,,162.0,1.0,1.0,2.0,0.0,0.0,0.0,2.0,0.0,1.0,5.0,0.0,5.0,0.0,3.0,0.0,0.0
2025-01-19 00:00:00+00:00,134.0,533.0,105.0,27.0,94.0,954.0,25.0,32.0,21.0,3.0,177.0,0.0,4.0,4.0,4.0,19.0,33.0,2.0,6.0,5.0,0.0,1.0,3.0,3.0,10.0,0.0,3.0,,0.0,3.0,3.0,,110.0,12.0,3.0,9.0,4.0,30.0,2.0,6.0,3.0,18.0,2.0,2.0,220.0,2.0,1.0,23.0,2.0,2.0,0.0,149.0,0.0,27.0,1.0,3.0,4.0,4.0,,0.0,7.0,0.0,2.0,4.0,4.0,0.0,36.0,0.0,0.0,7.0,2.0,1.0,26.0,0.0,3.0,2.0,1.0,52.0,3.0,2.0,0.0,18.0,0.0,0.0,149.0,0.0,4.0,,1104.0,26.0,,0.0,1.0,,0.0,3.0,2.0,2.0,3.0,0.0,1.0,249.0,1.0,2.0,6.0,22.0,57.0,6.0,1.0,0.0,0.0,188.0,3.0,0.0,0.0,59.0,414.0,,227.0,3.0,0.0,1.0,0.0,0.0,0.0,0.0,0.0,2.0,1.0,12.0,11.0,1.0,2.0,1.0,0.0
2025-01-20 00:00:00+00:00,181.0,456.0,80.0,92.0,60.0,854.0,61.0,25.0,53.0,15.0,150.0,5.0,4.0,5.0,3.0,8.0,13.0,7.0,5.0,0.0,0.0,4.0,1.0,4.0,15.0,1.0,1.0,,0.0,3.0,1.0,,102.0,6.0,3.0,8.0,5.0,30.0,3.0,11.0,3.0,26.0,2.0,9.0,98.0,5.0,2.0,17.0,1.0,1.0,0.0,88.0,0.0,14.0,0.0,1.0,6.0,9.0,,0.0,1.0,0.0,1.0,3.0,3.0,2.0,39.0,0.0,1.0,11.0,7.0,0.0,25.0,1.0,1.0,3.0,1.0,59.0,16.0,2.0,1.0,5.0,0.0,0.0,175.0,0.0,1.0,,1192.0,16.0,,4.0,1.0,,3.0,9.0,5.0,0.0,3.0,1.0,8.0,114.0,2.0,0.0,18.0,18.0,60.0,14.0,4.0,5.0,2.0,203.0,2.0,0.0,1.0,48.0,387.0,,206.0,4.0,0.0,0.0,0.0,0.0,0.0,0.0,0.0,3.0,2.0,0.0,7.0,1.0,1.0,0.0,0.0
2025-01-21 00:00:00+00:00,191.0,371.0,85.0,62.0,32.0,610.0,51.0,55.0,36.0,29.0,153.0,1.0,2.0,7.0,5.0,8.0,19.0,7.0,4.0,1.0,0.0,2.0,5.0,13.0,19.0,0.0,3.0,,1.0,2.0,2.0,,30.0,7.0,6.0,0.0,5.0,9.0,1.0,3.0,7.0,24.0,1.0,6.0,90.0,8.0,0.0,26.0,2.0,1.0,2.0,72.0,1.0,50.0,2.0,2.0,1.0,6.0,,1.0,0.0,0.0,1.0,8.0,3.0,3.0,39.0,0.0,2.0,7.0,7.0,0.0,25.0,2.0,3.0,2.0,0.0,59.0,13.0,1.0,2.0,24.0,0.0,0.0,108.0,0.0,3.0,,965.0,26.0,,5.0,0.0,,1.0,3.0,1.0,2.0,1.0,1.0,8.0,68.0,0.0,0.0,12.0,12.0,57.0,6.0,1.0,4.0,1.0,154.0,5.0,0.0,3.0,63.0,332.0,,184.0,0.0,1.0,0.0,0.0,0.0,2.0,0.0,0.0,18.0,14.0,0.0,10.0,0.0,2.0,0.0,0.0
2025-01-22 00:00:00+00:00,191.0,314.0,142.0,59.0,37.0,753.0,21.0,43.0,34.0,10.0,78.0,4.0,2.0,6.0,4.0,17.0,22.0,11.0,2.0,2.0,0.0,4.0,6.0,19.0,4.0,0.0,8.0,,10.0,4.0,1.0,,16.0,15.0,3.0,1.0,1.0,17.0,4.0,2.0,6.0,21.0,6.0,4.0,49.0,4.0,2.0,30.0,2.0,0.0,2.0,78.0,0.0,28.0,4.0,1.0,5.0,4.0,,0.0,1.0,3.0,1.0,6.0,2.0,9.0,28.0,1.0,1.0,3.0,11.0,1.0,14.0,0.0,1.0,4.0,0.0,77.0,8.0,11.0,0.0,19.0,0.0,0.0,124.0,0.0,1.0,,912.0,17.0,,2.0,0.0,,1.0,7.0,0.0,0.0,2.0,1.0,7.0,65.0,1.0,0.0,22.0,7.0,67.0,6.0,2.0,4.0,3.0,137.0,3.0,0.0,0.0,49.0,304.0,,182.0,0.0,3.0,0.0,0.0,0.0,0.0,0.0,0.0,3.0,11.0,0.0,5.0,0.0,0.0,0.0,0.0
2025-01-23 00:00:00+00:00,189.0,354.0,75.0,44.0,82.0,822.0,18.0,37.0,39.0,7.0,72.0,3.0,5.0,4.0,7.0,26.0,19.0,8.0,4.0,3.0,0.0,1.0,4.0,31.0,7.0,0.0,4.0,,4.0,2.0,2.0,,20.0,9.0,3.0,5.0,6.0,21.0,1.0,8.0,5.0,16.0,0.0,4.0,81.0,6.0,0.0,26.0,2.0,1.0,2.0,79.0,0.0,31.0,3.0,4.0,41.0,6.0,,0.0,0.0,0.0,0.0,3.0,0.0,6.0,27.0,0.0,1.0,6.0,8.0,0.0,22.0,1.0,2.0,4.0,2.0,43.0,3.0,6.0,0.0,16.0,0.0,0.0,127.0,0.0,4.0,,966.0,10.0,,0.0,0.0,,0.0,2.0,3.0,1.0,3.0,0.0,5.0,83.0,0.0,1.0,17.0,7.0,57.0,4.0,0.0,9.0,3.0,145.0,6.0,1.0,0.0,38.0,316.0,,160.0,2.0,0.0,1.0,0.0,0.0,0.0,1.0,0.0,0.0,8.0,1.0,15.0,2.0,0.0,1.0,0.0
2025-01-24 00:00:00+00:00,162.0,261.0,71.0,27.0,95.0,885.0,29.0,47.0,26.0,41.0,43.0,1.0,2.0,3.0,11.0,219.0,24.0,7.0,6.0,2.0,0.0,1.0,3.0,8.0,26.0,0.0,3.0,,1.0,2.0,6.0,,21.0,4.0,2.0,6.0,9.0,13.0,1.0,5.0,10.0,24.0,6.0,2.0,83.0,2.0,4.0,22.0,2.0,4.0,2.0,76.0,0.0,32.0,4.0,6.0,9.0,6.0,,0.0,2.0,3.0,0.0,5.0,1.0,5.0,42.0,1.0,1.0,7.0,7.0,3.0,21.0,1.0,1.0,7.0,3.0,59.0,1.0,5.0,1.0,7.0,0.0,0.0,130.0,0.0,3.0,,911.0,22.0,,3.0,0.0,,2.0,1.0,3.0,0.0,4.0,0.0,6.0,115.0,1.0,0.0,9.0,22.0,60.0,11.0,3.0,11.0,0.0,154.0,9.0,2.0,0.0,28.0,285.0,,170.0,0.0,0.0,1.0,0.0,0.0,0.0,0.0,1.0,2.0,6.0,1.0,8.0,0.0,0.0,2.0,0.0
2025-01-25 00:00:00+00:00,127.0,249.0,50.0,19.0,71.0,722.0,8.0,40.0,18.0,13.0,51.0,1.0,0.0,1.0,6.0,74.0,22.0,4.0,5.0,2.0,0.0,5.0,1.0,14.0,18.0,0.0,3.0,,9.0,1.0,1.0,,14.0,2.0,7.0,4.0,4.0,7.0,0.0,5.0,7.0,25.0,3.0,0.0,47.0,3.0,1.0,12.0,3.0,2.0,1.0,73.0,1.0,31.0,2.0,1.0,12.0,3.0,,0.0,2.0,0.0,1.0,1.0,0.0,0.0,29.0,1.0,0.0,4.0,4.0,0.0,16.0,0.0,1.0,2.0,0.0,92.0,0.0,10.0,0.0,5.0,0.0,0.0,96.0,0.0,3.0,,689.0,18.0,,3.0,0.0,,0.0,2.0,1.0,1.0,1.0,2.0,3.0,111.0,0.0,2.0,14.0,15.0,55.0,5.0,1.0,2.0,1.0,131.0,11.0,0.0,0.0,54.0,243.0,,145.0,1.0,0.0,1.0,0.0,0.0,0.0,5.0,0.0,0.0,3.0,1.0,4.0,0.0,2.0,0.0,0.0
2025-01-26 00:00:00+00:00,122.0,225.0,90.0,21.0,57.0,757.0,14.0,28.0,13.0,26.0,40.0,2.0,5.0,3.0,3.0,51.0,14.0,1.0,1.0,0.0,0.0,4.0,6.0,12.0,9.0,1.0,7.0,,4.0,0.0,2.0,,16.0,6.0,7.0,3.0,2.0,14.0,0.0,4.0,4.0,16.0,25.0,1.0,52.0,4.0,1.0,10.0,5.0,3.0,1.0,74.0,0.0,72.0,1.0,2.0,5.0,1.0,,1.0,0.0,1.0,0.0,1.0,0.0,3.0,26.0,0.0,1.0,9.0,1.0,1.0,16.0,3.0,0.0,3.0,0.0,59.0,0.0,6.0,4.0,2.0,0.0,0.0,164.0,0.0,0.0,,755.0,19.0,,0.0,0.0,,1.0,3.0,0.0,2.0,2.0,1.0,2.0,74.0,0.0,0.0,12.0,6.0,57.0,3.0,1.0,1.0,1.0,85.0,1.0,0.0,2.0,59.0,213.0,,165.0,0.0,0.0,0.0,0.0,0.0,3.0,2.0,0.0,0.0,0.0,0.0,3.0,0.0,1.0,0.0,0.0
2025-01-27 00:00:00+00:00,99.0,278.0,69.0,32.0,59.0,715.0,8.0,24.0,25.0,9.0,44.0,10.0,6.0,5.0,10.0,49.0,10.0,13.0,8.0,2.0,0.0,4.0,3.0,13.0,19.0,0.0,5.0,,1.0,0.0,1.0,,11.0,4.0,1.0,2.0,5.0,27.0,0.0,6.0,6.0,19.0,5.0,1.0,109.0,6.0,1.0,15.0,8.0,2.0,4.0,90.0,1.0,69.0,2.0,3.0,9.0,4.0,,0.0,1.0,0.0,2.0,4.0,1.0,2.0,26.0,0.0,2.0,4.0,13.0,0.0,14.0,0.0,0.0,4.0,0.0,102.0,6.0,3.0,0.0,13.0,0.0,0.0,94.0,0.0,2.0,,774.0,11.0,,2.0,0.0,,1.0,3.0,5.0,1.0,2.0,0.0,8.0,69.0,3.0,0.0,36.0,7.0,57.0,2.0,4.0,2.0,0.0,153.0,9.0,1.0,0.0,47.0,262.0,,169.0,1.0,1.0,0.0,0.0,0.0,20.0,0.0,0.0,2.0,3.0,0.0,6.0,0.0,3.0,2.0,0.0
2025-01-28 00:00:00+00:00,141.0,246.0,79.0,23.0,103.0,666.0,11.0,32.0,34.0,7.0,48.0,0.0,1.0,5.0,15.0,24.0,19.0,17.0,6.0,1.0,0.0,1.0,5.0,10.0,34.0,0.0,5.0,,12.0,0.0,2.0,,18.0,6.0,6.0,9.0,13.0,14.0,1.0,13.0,5.0,23.0,1.0,2.0,34.0,5.0,0.0,18.0,5.0,0.0,1.0,77.0,1.0,65.0,10.0,2.0,6.0,0.0,,0.0,0.0,2.0,4.0,1.0,4.0,0.0,46.0,2.0,2.0,4.0,17.0,0.0,14.0,0.0,5.0,2.0,2.0,66.0,2.0,3.0,1.0,11.0,0.0,0.0,134.0,1.0,5.0,,702.0,12.0,,1.0,0.0,,0.0,2.0,11.0,1.0,3.0,1.0,9.0,98.0,1.0,1.0,21.0,10.0,62.0,5.0,2.0,4.0,0.0,110.0,7.0,0.0,3.0,41.0,243.0,,143.0,2.0,2.0,0.0,0.0,0.0,3.0,0.0,1.0,3.0,7.0,0.0,7.0,0.0,2.0,0.0,0.0
2025-01-29 00:00:00+00:00,163.0,261.0,108.0,30.0,79.0,825.0,13.0,39.0,35.0,8.0,50.0,4.0,2.0,4.0,7.0,28.0,15.0,11.0,7.0,0.0,0.0,3.0,16.0,5.0,7.0,0.0,6.0,,3.0,0.0,4.0,,25.0,4.0,0.0,1.0,15.0,13.0,3.0,6.0,0.0,12.0,3.0,6.0,71.0,5.0,0.0,20.0,3.0,3.0,0.0,56.0,0.0,44.0,0.0,4.0,3.0,1.0,,0.0,0.0,1.0,1.0,4.0,0.0,0.0,27.0,0.0,1.0,4.0,11.0,0.0,24.0,0.0,2.0,2.0,2.0,90.0,8.0,6.0,1.0,5.0,0.0,0.0,155.0,0.0,3.0,,757.0,12.0,,1.0,0.0,,0.0,3.0,2.0,1.0,4.0,4.0,11.0,100.0,1.0,0.0,19.0,6.0,56.0,9.0,7.0,4.0,0.0,112.0,4.0,1.0,5.0,34.0,215.0,,160.0,2.0,0.0,1.0,0.0,0.0,1.0,0.0,0.0,4.0,27.0,0.0,10.0,1.0,2.0,0.0,0.0
2025-01-30 00:00:00+00:00,172.0,309.0,76.0,32.0,70.0,723.0,16.0,40.0,35.0,12.0,70.0,5.0,2.0,3.0,5.0,22.0,10.0,7.0,11.0,0.0,0.0,5.0,6.0,9.0,26.0,0.0,3.0,,7.0,1.0,3.0,,19.0,9.0,5.0,4.0,4.0,9.0,5.0,13.0,7.0,14.0,1.0,8.0,77.0,1.0,1.0,21.0,2.0,0.0,1.0,58.0,0.0,24.0,2.0,3.0,8.0,1.0,,1.0,1.0,0.0,0.0,7.0,2.0,0.0,40.0,0.0,0.0,5.0,7.0,0.0,17.0,1.0,2.0,0.0,0.0,79.0,6.0,5.0,1.0,8.0,0.0,0.0,114.0,0.0,1.0,,776.0,16.0,,0.0,0.0,,0.0,2.0,8.0,1.0,2.0,2.0,10.0,84.0,3.0,1.0,14.0,13.0,37.0,5.0,4.0,6.0,0.0,119.0,3.0,0.0,2.0,57.0,241.0,,140.0,1.0,0.0,0.0,0.0,0.0,0.0,0.0,1.0,0.0,21.0,0.0,10.0,1.0,1.0,1.0,0.0
2025-01-31 00:00:00+00:00,133.0,227.0,100.0,39.0,68.0,613.0,10.0,29.0,65.0,26.0,57.0,16.0,3.0,0.0,5.0,13.0,7.0,4.0,14.0,1.0,0.0,3.0,1.0,7.0,25.0,0.0,3.0,,3.0,1.0,1.0,,13.0,4.0,0.0,3.0,17.0,8.0,1.0,6.0,3.0,21.0,0.0,7.0,79.0,4.0,1.0,16.0,3.0,1.0,0.0,68.0,0.0,27.0,0.0,3.0,2.0,2.0,,0.0,0.0,2.0,1.0,5.0,0.0,0.0,29.0,1.0,2.0,1.0,4.0,0.0,17.0,1.0,3.0,0.0,0.0,101.0,3.0,4.0,0.0,0.0,0.0,0.0,90.0,0.0,1.0,,637.0,9.0,,2.0,1.0,,0.0,1.0,2.0,0.0,2.0,7.0,6.0,89.0,1.0,1.0,16.0,4.0,57.0,4.0,3.0,7.0,4.0,114.0,4.0,1.0,5.0,51.0,233.0,,142.0,2.0,0.0,1.0,1.0,0.0,2.0,1.0,0.0,2.0,6.0,0.0,9.0,0.0,2.0,2.0,1.0
2025-02-01 00:00:00+00:00,109.0,187.0,75.0,26.0,40.0,563.0,12.0,37.0,14.0,8.0,39.0,3.0,2.0,1.0,1.0,110.0,8.0,4.0,7.0,0.0,0.0,1.0,2.0,1.0,12.0,0.0,2.0,,1.0,1.0,0.0,,5.0,3.0,1.0,2.0,5.0,7.0,2.0,11.0,5.0,17.0,0.0,0.0,73.0,1.0,1.0,19.0,6.0,1.0,1.0,68.0,0.0,16.0,0.0,2.0,3.0,1.0,,0.0,0.0,2.0,1.0,0.0,4.0,1.0,25.0,0.0,0.0,4.0,4.0,6.0,17.0,0.0,1.0,2.0,5.0,54.0,1.0,3.0,1.0,10.0,0.0,0.0,134.0,0.0,0.0,,567.0,9.0,,0.0,0.0,,0.0,0.0,3.0,0.0,1.0,2.0,3.0,57.0,2.0,1.0,12.0,7.0,42.0,3.0,4.0,1.0,0.0,74.0,8.0,0.0,3.0,39.0,169.0,,116.0,2.0,0.0,0.0,0.0,0.0,0.0,0.0,1.0,0.0,3.0,0.0,2.0,0.0,0.0,2.0,0.0
2025-02-02 00:00:00+00:00,92.0,226.0,67.0,20.0,41.0,687.0,3.0,36.0,20.0,4.0,54.0,1.0,1.0,5.0,0.0,115.0,14.0,2.0,3.0,3.0,0.0,0.0,3.0,3.0,15.0,0.0,3.0,,6.0,2.0,0.0,,7.0,7.0,0.0,1.0,3.0,8.0,1.0,12.0,2.0,13.0,1.0,0.0,74.0,6.0,3.0,16.0,12.0,2.0,0.0,87.0,0.0,12.0,2.0,3.0,2.0,2.0,,0.0,1.0,1.0,3.0,2.0,2.0,0.0,26.0,0.0,1.0,5.0,2.0,5.0,16.0,1.0,2.0,2.0,0.0,85.0,1.0,9.0,0.0,1.0,0.0,0.0,120.0,0.0,0.0,,638.0,15.0,,0.0,0.0,,1.0,0.0,4.0,1.0,3.0,0.0,1.0,76.0,1.0,0.0,9.0,6.0,47.0,2.0,2.0,0.0,0.0,109.0,5.0,2.0,2.0,34.0,231.0,,124.0,0.0,0.0,1.0,0.0,0.0,5.0,0.0,0.0,2.0,6.0,0.0,5.0,0.0,1.0,1.0,0.0
2025-02-03 00:00:00+00:00,108.0,312.0,83.0,52.0,62.0,582.0,18.0,57.0,58.0,4.0,49.0,24.0,8.0,2.0,5.0,67.0,54.0,9.0,6.0,3.0,0.0,1.0,1.0,7.0,5.0,4.0,3.0,,10.0,2.0,3.0,,17.0,12.0,8.0,4.0,7.0,9.0,0.0,9.0,1.0,18.0,1.0,2.0,106.0,3.0,1.0,19.0,4.0,1.0,5.0,76.0,3.0,31.0,0.0,0.0,0.0,4.0,,2.0,1.0,0.0,1.0,3.0,2.0,0.0,23.0,3.0,3.0,5.0,9.0,1.0,20.0,1.0,5.0,3.0,1.0,89.0,3.0,0.0,2.0,12.0,0.0,0.0,138.0,0.0,2.0,,750.0,15.0,,1.0,1.0,,3.0,1.0,2.0,0.0,4.0,2.0,9.0,106.0,3.0,2.0,24.0,13.0,47.0,2.0,3.0,2.0,0.0,199.0,5.0,0.0,2.0,51.0,275.0,,172.0,0.0,2.0,0.0,0.0,0.0,0.0,0.0,0.0,2.0,14.0,1.0,6.0,0.0,1.0,4.0,0.0
2025-02-04 00:00:00+00:00,172.0,238.0,58.0,41.0,67.0,458.0,26.0,37.0,63.0,10.0,69.0,5.0,9.0,2.0,3.0,28.0,51.0,9.0,19.0,0.0,0.0,6.0,1.0,28.0,9.0,1.0,7.0,,16.0,0.0,2.0,,13.0,9.0,6.0,3.0,8.0,34.0,3.0,5.0,4.0,28.0,0.0,6.0,79.0,1.0,0.0,16.0,2.0,1.0,1.0,43.0,0.0,19.0,4.0,1.0,2.0,5.0,,1.0,0.0,4.0,1.0,2.0,1.0,1.0,22.0,2.0,2.0,5.0,9.0,2.0,20.0,0.0,1.0,0.0,1.0,80.0,2.0,3.0,0.0,16.0,0.0,0.0,90.0,0.0,2.0,,644.0,20.0,,3.0,1.0,,2.0,1.0,7.0,0.0,3.0,2.0,10.0,55.0,1.0,0.0,19.0,7.0,49.0,1.0,0.0,2.0,1.0,133.0,5.0,0.0,4.0,42.0,241.0,,143.0,0.0,1.0,2.0,1.0,0.0,0.0,1.0,0.0,2.0,22.0,2.0,5.0,0.0,0.0,1.0,0.0
2025-02-05 00:00:00+00:00,208.0,241.0,62.0,34.0,110.0,535.0,20.0,36.0,31.0,6.0,61.0,1.0,3.0,19.0,3.0,19.0,40.0,5.0,1.0,1.0,0.0,4.0,2.0,12.0,34.0,1.0,1.0,,24.0,7.0,2.0,,13.0,11.0,4.0,6.0,5.0,9.0,5.0,7.0,6.0,24.0,1.0,11.0,56.0,26.0,3.0,20.0,0.0,3.0,3.0,70.0,1.0,14.0,0.0,5.0,6.0,4.0,,5.0,0.0,3.0,4.0,12.0,1.0,3.0,45.0,2.0,0.0,5.0,5.0,0.0,15.0,1.0,1.0,3.0,1.0,102.0,3.0,2.0,1.0,18.0,0.0,0.0,152.0,0.0,3.0,,643.0,10.0,,2.0,1.0,,3.0,0.0,4.0,1.0,2.0,3.0,10.0,70.0,1.0,2.0,20.0,10.0,43.0,4.0,2.0,4.0,3.0,145.0,3.0,0.0,4.0,60.0,224.0,,151.0,0.0,1.0,2.0,0.0,1.0,0.0,0.0,1.0,3.0,21.0,0.0,6.0,0.0,0.0,0.0,0.0
2025-02-06 00:00:00+00:00,154.0,247.0,73.0,31.0,156.0,557.0,16.0,42.0,52.0,19.0,60.0,1.0,2.0,18.0,8.0,32.0,40.0,7.0,4.0,1.0,0.0,3.0,16.0,7.0,7.0,0.0,5.0,,7.0,2.0,2.0,,15.0,10.0,8.0,3.0,17.0,9.0,4.0,14.0,4.0,23.0,1.0,5.0,63.0,3.0,0.0,22.0,4.0,3.0,5.0,116.0,0.0,24.0,1.0,2.0,5.0,6.0,,0.0,0.0,3.0,2.0,5.0,0.0,3.0,29.0,0.0,2.0,8.0,7.0,1.0,13.0,0.0,2.0,4.0,1.0,106.0,2.0,1.0,2.0,11.0,0.0,0.0,135.0,0.0,3.0,,681.0,10.0,,1.0,0.0,,0.0,4.0,3.0,5.0,4.0,1.0,9.0,77.0,9.0,1.0,39.0,15.0,59.0,0.0,1.0,7.0,0.0,138.0,3.0,0.0,1.0,51.0,205.0,,152.0,1.0,3.0,3.0,2.0,0.0,0.0,1.0,1.0,19.0,17.0,2.0,3.0,1.0,0.0,1.0,0.0
2025-02-07 00:00:00+00:00,186.0,265.0,93.0,32.0,133.0,575.0,15.0,42.0,18.0,7.0,42.0,1.0,2.0,6.0,7.0,46.0,45.0,7.0,7.0,1.0,0.0,5.0,4.0,14.0,13.0,0.0,4.0,,12.0,3.0,10.0,,14.0,13.0,4.0,1.0,5.0,10.0,2.0,4.0,4.0,33.0,1.0,10.0,73.0,11.0,1.0,22.0,2.0,0.0,5.0,177.0,2.0,15.0,0.0,2.0,6.0,3.0,,0.0,0.0,17.0,2.0,10.0,2.0,1.0,36.0,0.0,2.0,5.0,7.0,1.0,19.0,0.0,5.0,3.0,1.0,72.0,2.0,7.0,0.0,5.0,0.0,0.0,114.0,0.0,1.0,,651.0,15.0,,1.0,2.0,,0.0,2.0,4.0,13.0,0.0,3.0,7.0,88.0,0.0,1.0,13.0,11.0,87.0,3.0,0.0,7.0,0.0,102.0,3.0,0.0,2.0,54.0,211.0,,159.0,0.0,1.0,1.0,0.0,0.0,0.0,0.0,1.0,1.0,5.0,0.0,10.0,0.0,6.0,1.0,0.0
2025-02-08 00:00:00+00:00,92.0,247.0,80.0,24.0,75.0,496.0,15.0,26.0,26.0,4.0,36.0,1.0,3.0,3.0,1.0,14.0,17.0,6.0,7.0,1.0,0.0,0.0,1.0,25.0,1.0,0.0,1.0,,41.0,2.0,6.0,,9.0,6.0,4.0,4.0,5.0,14.0,4.0,3.0,1.0,19.0,0.0,7.0,79.0,7.0,0.0,28.0,2.0,2.0,1.0,158.0,2.0,13.0,1.0,4.0,2.0,1.0,,0.0,0.0,0.0,0.0,2.0,0.0,1.0,27.0,1.0,1.0,7.0,6.0,0.0,13.0,0.0,0.0,4.0,9.0,59.0,3.0,1.0,0.0,11.0,0.0,0.0,132.0,0.0,1.0,,516.0,14.0,,6.0,0.0,,0.0,1.0,3.0,7.0,0.0,3.0,1.0,63.0,1.0,0.0,18.0,9.0,42.0,1.0,0.0,0.0,0.0,84.0,3.0,0.0,3.0,35.0,194.0,,150.0,6.0,2.0,5.0,0.0,0.0,0.0,0.0,2.0,4.0,5.0,4.0,4.0,0.0,1.0,2.0,0.0
2025-02-09 00:00:00+00:00,109.0,198.0,70.0,13.0,75.0,455.0,10.0,23.0,12.0,12.0,35.0,1.0,3.0,12.0,3.0,16.0,22.0,4.0,3.0,0.0,0.0,1.0,1.0,16.0,9.0,0.0,3.0,,7.0,3.0,3.0,,14.0,2.0,2.0,1.0,6.0,5.0,2.0,5.0,3.0,11.0,1.0,1.0,74.0,22.0,0.0,16.0,2.0,0.0,1.0,61.0,0.0,16.0,1.0,1.0,3.0,2.0,,0.0,1.0,1.0,2.0,1.0,0.0,1.0,25.0,0.0,1.0,6.0,4.0,1.0,18.0,0.0,0.0,5.0,2.0,61.0,9.0,0.0,0.0,1.0,0.0,0.0,123.0,0.0,2.0,,599.0,15.0,,3.0,0.0,,0.0,0.0,8.0,11.0,6.0,2.0,6.0,49.0,1.0,0.0,6.0,10.0,40.0,5.0,1.0,0.0,0.0,77.0,2.0,0.0,3.0,65.0,178.0,,136.0,0.0,1.0,4.0,0.0,0.0,0.0,0.0,0.0,0.0,2.0,5.0,5.0,0.0,1.0,0.0,0.0
2025-02-10 00:00:00+00:00,82.0,189.0,48.0,25.0,51.0,387.0,19.0,41.0,44.0,7.0,50.0,3.0,3.0,10.0,5.0,26.0,31.0,5.0,3.0,1.0,0.0,1.0,4.0,29.0,4.0,0.0,4.0,,8.0,1.0,3.0,,12.0,4.0,2.0,0.0,4.0,10.0,4.0,6.0,1.0,22.0,1.0,9.0,59.0,14.0,1.0,21.0,2.0,0.0,1.0,58.0,1.0,12.0,1.0,5.0,4.0,3.0,,2.0,3.0,2.0,1.0,6.0,6.0,0.0,21.0,0.0,1.0,5.0,5.0,2.0,20.0,3.0,4.0,2.0,1.0,72.0,6.0,5.0,0.0,11.0,0.0,0.0,180.0,0.0,3.0,,532.0,14.0,,6.0,1.0,,0.0,5.0,8.0,4.0,2.0,3.0,7.0,63.0,0.0,0.0,14.0,25.0,45.0,3.0,1.0,6.0,2.0,106.0,5.0,0.0,11.0,74.0,197.0,,121.0,1.0,1.0,0.0,0.0,0.0,0.0,2.0,1.0,4.0,7.0,1.0,7.0,0.0,0.0,1.0,0.0
2025-02-11 00:00:00+00:00,101.0,228.0,138.0,31.0,69.0,502.0,10.0,23.0,32.0,11.0,62.0,5.0,7.0,7.0,3.0,23.0,20.0,10.0,2.0,0.0,0.0,1.0,6.0,13.0,15.0,0.0,5.0,,6.0,1.0,0.0,,8.0,4.0,2.0,4.0,6.0,7.0,6.0,4.0,6.0,26.0,1.0,0.0,62.0,43.0,2.0,19.0,3.0,0.0,1.0,49.0,0.0,8.0,3.0,1.0,3.0,3.0,,3.0,0.0,3.0,1.0,6.0,1.0,0.0,24.0,1.0,0.0,6.0,10.0,0.0,13.0,1.0,1.0,2.0,0.0,78.0,4.0,2.0,1.0,2.0,0.0,0.0,175.0,0.0,3.0,,552.0,4.0,,3.0,1.0,,3.0,1.0,3.0,0.0,15.0,4.0,9.0,65.0,3.0,1.0,19.0,11.0,59.0,4.0,2.0,4.0,3.0,100.0,2.0,0.0,2.0,42.0,209.0,,126.0,3.0,1.0,2.0,0.0,0.0,2.0,0.0,0.0,1.0,19.0,3.0,9.0,0.0,0.0,2.0,0.0
2025-02-12 00:00:00+00:00,114.0,185.0,72.0,28.0,56.0,471.0,9.0,27.0,17.0,8.0,49.0,2.0,1.0,6.0,6.0,24.0,24.0,4.0,10.0,2.0,0.0,4.0,2.0,8.0,11.0,0.0,4.0,,4.0,4.0,3.0,,8.0,10.0,2.0,4.0,11.0,13.0,2.0,3.0,7.0,17.0,2.0,3.0,77.0,17.0,1.0,26.0,9.0,1.0,0.0,64.0,1.0,14.0,0.0,2.0,5.0,9.0,,2.0,2.0,4.0,5.0,8.0,1.0,0.0,23.0,0.0,4.0,7.0,4.0,1.0,17.0,1.0,4.0,2.0,3.0,67.0,8.0,3.0,1.0,7.0,0.0,0.0,221.0,0.0,1.0,,593.0,7.0,,10.0,1.0,,1.0,2.0,2.0,0.0,2.0,3.0,6.0,211.0,1.0,0.0,31.0,7.0,53.0,2.0,3.0,5.0,0.0,96.0,3.0,0.0,1.0,41.0,216.0,,114.0,1.0,0.0,0.0,0.0,0.0,0.0,0.0,0.0,5.0,12.0,1.0,4.0,0.0,3.0,1.0,0.0
2025-02-13 00:00:00+00:00,104.0,217.0,58.0,47.0,80.0,466.0,14.0,36.0,24.0,20.0,48.0,4.0,9.0,3.0,4.0,12.0,62.0,4.0,16.0,0.0,0.0,5.0,4.0,23.0,10.0,1.0,4.0,,5.0,1.0,1.0,,12.0,15.0,5.0,2.0,4.0,12.0,3.0,10.0,8.0,12.0,1.0,6.0,70.0,2.0,0.0,16.0,18.0,1.0,1.0,84.0,0.0,5.0,3.0,0.0,1.0,2.0,,1.0,1.0,0.0,2.0,2.0,1.0,1.0,20.0,0.0,12.0,6.0,4.0,0.0,12.0,1.0,7.0,7.0,0.0,50.0,1.0,1.0,0.0,2.0,0.0,0.0,172.0,0.0,4.0,,608.0,11.0,,17.0,2.0,,0.0,1.0,1.0,2.0,4.0,2.0,3.0,186.0,0.0,3.0,18.0,16.0,45.0,1.0,1.0,6.0,0.0,111.0,2.0,0.0,1.0,27.0,204.0,,157.0,2.0,1.0,0.0,0.0,1.0,0.0,0.0,0.0,3.0,6.0,0.0,3.0,2.0,2.0,3.0,0.0
2025-02-14 00:00:00+00:00,115.0,239.0,54.0,40.0,51.0,450.0,14.0,25.0,32.0,11.0,66.0,2.0,8.0,5.0,4.0,12.0,70.0,3.0,16.0,0.0,0.0,1.0,9.0,9.0,6.0,1.0,5.0,150.0,6.0,1.0,1.0,,12.0,7.0,1.0,0.0,4.0,11.0,2.0,9.0,5.0,16.0,6.0,6.0,55.0,12.0,1.0,20.0,5.0,1.0,0.0,76.0,0.0,14.0,0.0,3.0,6.0,3.0,33.0,1.0,0.0,2.0,1.0,5.0,0.0,3.0,26.0,4.0,2.0,10.0,3.0,0.0,17.0,0.0,9.0,3.0,2.0,89.0,0.0,0.0,0.0,9.0,0.0,0.0,164.0,0.0,1.0,,581.0,6.0,0.0,3.0,0.0,,1.0,0.0,1.0,0.0,2.0,1.0,2.0,73.0,0.0,3.0,15.0,10.0,39.0,3.0,2.0,3.0,1.0,107.0,4.0,0.0,0.0,29.0,181.0,,111.0,0.0,2.0,0.0,0.0,0.0,2.0,0.0,1.0,0.0,13.0,0.0,5.0,0.0,0.0,2.0,0.0
2025-02-15 00:00:00+00:00,103.0,160.0,38.0,16.0,39.0,419.0,9.0,28.0,30.0,8.0,41.0,5.0,9.0,9.0,1.0,10.0,96.0,1.0,3.0,0.0,0.0,3.0,2.0,17.0,10.0,0.0,2.0,79.0,5.0,5.0,0.0,,17.0,10.0,1.0,4.0,5.0,11.0,0.0,1.0,3.0,8.0,2.0,3.0,62.0,2.0,1.0,19.0,5.0,0.0,1.0,39.0,0.0,18.0,1.0,2.0,2.0,2.0,20.0,0.0,1.0,0.0,1.0,3.0,1.0,0.0,41.0,3.0,3.0,5.0,1.0,1.0,11.0,2.0,0.0,3.0,0.0,78.0,0.0,3.0,2.0,4.0,0.0,0.0,143.0,0.0,5.0,,577.0,10.0,0.0,3.0,0.0,,0.0,0.0,3.0,1.0,1.0,1.0,1.0,59.0,1.0,0.0,18.0,5.0,68.0,2.0,0.0,1.0,0.0,88.0,1.0,1.0,0.0,25.0,204.0,,120.0,0.0,0.0,1.0,0.0,0.0,0.0,0.0,0.0,3.0,3.0,0.0,4.0,0.0,1.0,1.0,0.0
2025-02-16 00:00:00+00:00,125.0,190.0,48.0,16.0,26.0,409.0,6.0,35.0,21.0,1.0,29.0,2.0,2.0,4.0,2.0,16.0,51.0,3.0,1.0,0.0,0.0,3.0,5.0,13.0,15.0,1.0,3.0,99.0,5.0,1.0,1.0,,7.0,3.0,4.0,1.0,4.0,12.0,1.0,4.0,0.0,29.0,2.0,0.0,55.0,6.0,0.0,18.0,9.0,0.0,0.0,72.0,0.0,26.0,4.0,4.0,2.0,0.0,54.0,1.0,0.0,0.0,1.0,0.0,1.0,0.0,27.0,0.0,1.0,7.0,3.0,0.0,12.0,0.0,1.0,3.0,2.0,69.0,4.0,0.0,0.0,3.0,0.0,0.0,180.0,0.0,5.0,,487.0,9.0,0.0,0.0,1.0,,2.0,1.0,0.0,1.0,3.0,2.0,4.0,59.0,0.0,1.0,13.0,7.0,40.0,3.0,3.0,0.0,0.0,72.0,3.0,0.0,0.0,36.0,172.0,,116.0,0.0,0.0,1.0,0.0,0.0,1.0,2.0,0.0,0.0,1.0,23.0,3.0,0.0,1.0,2.0,0.0
2025-02-17 00:00:00+00:00,89.0,235.0,55.0,19.0,43.0,498.0,16.0,35.0,32.0,14.0,32.0,3.0,1.0,5.0,5.0,15.0,37.0,9.0,3.0,1.0,0.0,2.0,4.0,9.0,1.0,0.0,3.0,128.0,6.0,1.0,2.0,,11.0,5.0,1.0,2.0,2.0,5.0,0.0,5.0,7.0,15.0,9.0,1.0,75.0,2.0,2.0,12.0,6.0,2.0,8.0,73.0,2.0,17.0,3.0,1.0,7.0,0.0,44.0,7.0,2.0,1.0,2.0,1.0,2.0,0.0,18.0,2.0,1.0,7.0,9.0,1.0,17.0,1.0,7.0,0.0,2.0,45.0,10.0,3.0,0.0,22.0,0.0,0.0,94.0,0.0,2.0,,567.0,10.0,0.0,2.0,0.0,,0.0,0.0,1.0,1.0,1.0,2.0,4.0,47.0,1.0,1.0,14.0,11.0,63.0,1.0,2.0,2.0,1.0,92.0,2.0,0.0,2.0,34.0,199.0,,121.0,1.0,0.0,1.0,0.0,0.0,0.0,0.0,0.0,0.0,2.0,0.0,2.0,0.0,3.0,0.0,0.0
2025-02-18 00:00:00+00:00,111.0,311.0,56.0,27.0,54.0,560.0,12.0,63.0,36.0,4.0,43.0,2.0,19.0,8.0,3.0,12.0,44.0,6.0,4.0,0.0,0.0,4.0,1.0,20.0,11.0,1.0,7.0,119.0,12.0,0.0,1.0,,15.0,18.0,1.0,3.0,12.0,12.0,0.0,6.0,4.0,22.0,14.0,2.0,70.0,1.0,0.0,24.0,5.0,0.0,1.0,110.0,0.0,15.0,3.0,2.0,8.0,2.0,29.0,1.0,0.0,1.0,1.0,3.0,1.0,0.0,45.0,3.0,1.0,18.0,6.0,0.0,12.0,0.0,3.0,3.0,1.0,56.0,6.0,9.0,0.0,20.0,0.0,0.0,257.0,0.0,3.0,,622.0,18.0,0.0,3.0,1.0,,0.0,2.0,2.0,0.0,1.0,4.0,2.0,69.0,2.0,2.0,22.0,9.0,51.0,4.0,2.0,2.0,1.0,107.0,6.0,1.0,0.0,36.0,243.0,,120.0,1.0,3.0,1.0,0.0,1.0,0.0,0.0,0.0,4.0,7.0,0.0,6.0,0.0,0.0,0.0,0.0
2025-02-19 00:00:00+00:00,110.0,233.0,65.0,26.0,42.0,509.0,15.0,81.0,39.0,4.0,24.0,1.0,9.0,9.0,1.0,28.0,41.0,6.0,10.0,1.0,0.0,1.0,9.0,10.0,19.0,4.0,1.0,144.0,8.0,4.0,1.0,,8.0,3.0,0.0,2.0,6.0,14.0,4.0,2.0,4.0,14.0,8.0,6.0,64.0,0.0,0.0,23.0,5.0,3.0,2.0,76.0,0.0,10.0,3.0,27.0,4.0,5.0,27.0,0.0,0.0,0.0,0.0,4.0,1.0,1.0,44.0,1.0,2.0,6.0,6.0,0.0,22.0,0.0,4.0,3.0,1.0,80.0,6.0,0.0,2.0,8.0,0.0,0.0,188.0,0.0,3.0,,590.0,10.0,0.0,0.0,0.0,,1.0,5.0,2.0,0.0,2.0,2.0,4.0,71.0,0.0,3.0,58.0,13.0,52.0,3.0,2.0,5.0,1.0,88.0,3.0,0.0,0.0,40.0,248.0,,129.0,1.0,2.0,1.0,0.0,1.0,1.0,1.0,0.0,3.0,12.0,0.0,7.0,0.0,2.0,1.0,0.0
2025-02-20 00:00:00+00:00,123.0,255.0,70.0,12.0,45.0,471.0,7.0,76.0,37.0,6.0,31.0,2.0,17.0,5.0,6.0,17.0,44.0,12.0,4.0,2.0,0.0,3.0,1.0,11.0,28.0,0.0,5.0,169.0,11.0,3.0,0.0,,8.0,13.0,6.0,1.0,6.0,11.0,0.0,4.0,4.0,26.0,5.0,3.0,60.0,7.0,0.0,30.0,0.0,0.0,3.0,69.0,2.0,20.0,0.0,5.0,7.0,3.0,22.0,5.0,0.0,0.0,2.0,3.0,2.0,4.0,34.0,0.0,0.0,10.0,12.0,0.0,24.0,0.0,7.0,3.0,1.0,45.0,8.0,0.0,1.0,4.0,0.0,0.0,218.0,0.0,3.0,,529.0,10.0,1.0,2.0,0.0,,1.0,9.0,0.0,0.0,2.0,3.0,3.0,113.0,2.0,0.0,31.0,17.0,55.0,3.0,4.0,4.0,3.0,112.0,9.0,0.0,1.0,46.0,228.0,,146.0,2.0,0.0,0.0,0.0,0.0,1.0,0.0,0.0,4.0,17.0,0.0,8.0,1.0,3.0,1.0,0.0
2025-02-21 00:00:00+00:00,82.0,223.0,48.0,30.0,48.0,481.0,37.0,48.0,36.0,9.0,19.0,5.0,12.0,11.0,5.0,17.0,44.0,16.0,2.0,1.0,0.0,2.0,6.0,15.0,15.0,2.0,3.0,120.0,9.0,1.0,0.0,,7.0,11.0,2.0,2.0,5.0,14.0,0.0,4.0,7.0,28.0,3.0,23.0,79.0,5.0,1.0,34.0,7.0,1.0,2.0,90.0,0.0,25.0,0.0,1.0,3.0,0.0,21.0,0.0,1.0,1.0,2.0,3.0,2.0,5.0,37.0,2.0,0.0,10.0,16.0,0.0,17.0,1.0,3.0,5.0,1.0,70.0,4.0,1.0,1.0,4.0,0.0,0.0,160.0,0.0,6.0,,628.0,11.0,0.0,0.0,1.0,,2.0,2.0,1.0,0.0,1.0,1.0,3.0,60.0,3.0,1.0,21.0,19.0,50.0,5.0,0.0,7.0,1.0,81.0,5.0,1.0,1.0,25.0,226.0,,141.0,2.0,1.0,0.0,0.0,0.0,1.0,0.0,0.0,2.0,4.0,0.0,2.0,0.0,4.0,0.0,1.0
2025-02-22 00:00:00+00:00,79.0,135.0,61.0,15.0,33.0,416.0,28.0,39.0,15.0,4.0,35.0,0.0,5.0,1.0,1.0,53.0,33.0,4.0,2.0,2.0,0.0,1.0,2.0,4.0,6.0,1.0,3.0,87.0,1.0,0.0,0.0,,8.0,6.0,0.0,1.0,1.0,12.0,1.0,2.0,0.0,10.0,4.0,6.0,68.0,3.0,0.0,14.0,1.0,0.0,2.0,46.0,0.0,7.0,0.0,2.0,1.0,0.0,28.0,0.0,1.0,1.0,2.0,1.0,0.0,1.0,26.0,0.0,2.0,7.0,4.0,0.0,12.0,0.0,4.0,2.0,1.0,68.0,1.0,4.0,0.0,1.0,0.0,0.0,141.0,0.0,2.0,,563.0,11.0,1.0,1.0,0.0,,0.0,3.0,2.0,0.0,0.0,2.0,3.0,71.0,3.0,0.0,17.0,3.0,34.0,2.0,1.0,5.0,0.0,59.0,4.0,1.0,0.0,17.0,147.0,,108.0,0.0,0.0,2.0,0.0,0.0,1.0,1.0,0.0,3.0,1.0,0.0,5.0,0.0,3.0,3.0,0.0
2025-02-23 00:00:00+00:00,81.0,134.0,44.0,16.0,26.0,487.0,4.0,40.0,18.0,2.0,27.0,0.0,3.0,4.0,3.0,17.0,23.0,21.0,1.0,1.0,0.0,1.0,3.0,20.0,3.0,1.0,0.0,66.0,9.0,0.0,0.0,,3.0,3.0,7.0,2.0,3.0,9.0,6.0,4.0,1.0,11.0,4.0,1.0,47.0,2.0,0.0,15.0,5.0,1.0,0.0,47.0,1.0,16.0,2.0,7.0,4.0,0.0,25.0,0.0,0.0,0.0,1.0,3.0,0.0,4.0,18.0,0.0,2.0,2.0,21.0,1.0,20.0,1.0,1.0,4.0,0.0,44.0,2.0,1.0,1.0,0.0,0.0,0.0,71.0,0.0,3.0,,474.0,8.0,0.0,0.0,0.0,,2.0,0.0,0.0,1.0,0.0,1.0,2.0,38.0,0.0,0.0,19.0,9.0,39.0,0.0,0.0,6.0,0.0,59.0,2.0,0.0,0.0,37.0,174.0,,119.0,0.0,0.0,0.0,0.0,0.0,0.0,0.0,0.0,4.0,5.0,1.0,3.0,0.0,0.0,1.0,0.0
2025-02-24 00:00:00+00:00,145.0,235.0,66.0,30.0,58.0,496.0,32.0,69.0,22.0,8.0,159.0,2.0,19.0,2.0,3.0,20.0,26.0,12.0,3.0,1.0,0.0,4.0,10.0,104.0,3.0,1.0,3.0,127.0,53.0,2.0,0.0,,12.0,8.0,1.0,2.0,6.0,10.0,1.0,2.0,6.0,26.0,2.0,2.0,78.0,4.0,1.0,20.0,2.0,0.0,5.0,65.0,1.0,13.0,4.0,4.0,1.0,0.0,34.0,2.0,0.0,2.0,3.0,4.0,0.0,4.0,33.0,0.0,1.0,4.0,12.0,0.0,10.0,0.0,3.0,5.0,0.0,62.0,6.0,1.0,0.0,1.0,0.0,0.0,149.0,0.0,1.0,,535.0,7.0,0.0,1.0,0.0,,2.0,1.0,3.0,6.0,4.0,0.0,5.0,63.0,0.0,0.0,31.0,12.0,52.0,6.0,4.0,7.0,0.0,110.0,1.0,1.0,1.0,23.0,209.0,,150.0,1.0,0.0,0.0,0.0,0.0,0.0,3.0,0.0,3.0,9.0,0.0,2.0,0.0,3.0,2.0,0.0
2025-02-25 00:00:00+00:00,87.0,234.0,106.0,35.0,22.0,436.0,37.0,71.0,11.0,9.0,55.0,6.0,6.0,4.0,2.0,21.0,31.0,9.0,3.0,4.0,0.0,4.0,3.0,19.0,4.0,0.0,11.0,150.0,9.0,1.0,0.0,,12.0,5.0,0.0,2.0,2.0,41.0,1.0,0.0,4.0,29.0,2.0,1.0,88.0,3.0,3.0,15.0,4.0,2.0,0.0,51.0,0.0,17.0,5.0,2.0,3.0,0.0,27.0,0.0,0.0,0.0,1.0,1.0,1.0,1.0,16.0,3.0,2.0,6.0,9.0,0.0,15.0,0.0,5.0,3.0,5.0,59.0,1.0,4.0,1.0,0.0,0.0,0.0,139.0,0.0,4.0,,501.0,12.0,0.0,4.0,0.0,,2.0,5.0,2.0,3.0,0.0,2.0,6.0,76.0,1.0,0.0,10.0,10.0,57.0,2.0,4.0,5.0,0.0,134.0,6.0,0.0,2.0,40.0,249.0,,156.0,2.0,0.0,1.0,0.0,0.0,0.0,0.0,0.0,0.0,9.0,0.0,0.0,0.0,3.0,0.0,0.0
2025-02-26 00:00:00+00:00,105.0,182.0,95.0,23.0,46.0,347.0,11.0,50.0,28.0,5.0,44.0,3.0,3.0,5.0,3.0,24.0,20.0,7.0,19.0,4.0,1.0,3.0,3.0,13.0,7.0,1.0,6.0,84.0,10.0,2.0,2.0,,5.0,4.0,1.0,0.0,3.0,26.0,7.0,2.0,1.0,13.0,2.0,3.0,61.0,0.0,2.0,24.0,4.0,0.0,0.0,61.0,0.0,16.0,1.0,4.0,5.0,2.0,13.0,2.0,0.0,1.0,2.0,3.0,2.0,0.0,26.0,2.0,0.0,14.0,7.0,1.0,13.0,0.0,6.0,4.0,2.0,46.0,4.0,4.0,1.0,4.0,0.0,0.0,132.0,0.0,3.0,,413.0,13.0,2.0,3.0,1.0,,1.0,1.0,1.0,0.0,1.0,2.0,2.0,92.0,0.0,1.0,17.0,9.0,41.0,2.0,4.0,1.0,2.0,96.0,3.0,0.0,1.0,39.0,232.0,,112.0,2.0,0.0,0.0,0.0,0.0,0.0,1.0,0.0,2.0,25.0,0.0,9.0,0.0,3.0,6.0,0.0
2025-02-27 00:00:00+00:00,94.0,212.0,65.0,19.0,59.0,394.0,15.0,47.0,33.0,4.0,48.0,2.0,4.0,10.0,4.0,46.0,16.0,6.0,10.0,0.0,0.0,6.0,4.0,8.0,1.0,0.0,0.0,125.0,6.0,1.0,0.0,,9.0,9.0,4.0,2.0,4.0,11.0,1.0,3.0,3.0,15.0,1.0,4.0,69.0,4.0,3.0,18.0,4.0,1.0,2.0,61.0,0.0,8.0,6.0,4.0,4.0,1.0,27.0,0.0,1.0,3.0,1.0,3.0,1.0,0.0,24.0,0.0,2.0,3.0,6.0,0.0,12.0,0.0,1.0,6.0,11.0,60.0,4.0,0.0,0.0,0.0,0.0,0.0,180.0,0.0,2.0,,479.0,18.0,0.0,1.0,0.0,,2.0,4.0,2.0,0.0,2.0,4.0,2.0,69.0,0.0,1.0,28.0,4.0,40.0,1.0,2.0,45.0,0.0,107.0,2.0,1.0,0.0,33.0,234.0,,121.0,3.0,0.0,0.0,0.0,0.0,0.0,0.0,0.0,4.0,10.0,0.0,4.0,1.0,8.0,1.0,0.0
2025-02-28 00:00:00+00:00,69.0,227.0,88.0,15.0,48.0,427.0,11.0,24.0,28.0,2.0,41.0,4.0,1.0,1.0,2.0,81.0,9.0,14.0,17.0,2.0,0.0,2.0,7.0,13.0,2.0,0.0,1.0,93.0,10.0,0.0,0.0,,6.0,6.0,2.0,6.0,2.0,14.0,5.0,2.0,1.0,19.0,1.0,3.0,58.0,1.0,4.0,26.0,2.0,0.0,1.0,91.0,0.0,20.0,0.0,5.0,4.0,1.0,32.0,1.0,0.0,2.0,0.0,3.0,0.0,5.0,29.0,0.0,0.0,2.0,14.0,0.0,13.0,0.0,0.0,6.0,1.0,90.0,0.0,1.0,1.0,5.0,0.0,0.0,93.0,0.0,2.0,,482.0,13.0,0.0,0.0,0.0,,0.0,10.0,3.0,1.0,4.0,3.0,5.0,60.0,0.0,0.0,20.0,7.0,56.0,4.0,3.0,15.0,0.0,129.0,4.0,0.0,0.0,53.0,273.0,,142.0,2.0,0.0,1.0,0.0,1.0,0.0,0.0,0.0,2.0,4.0,1.0,3.0,0.0,1.0,0.0,0.0
2025-03-01 00:00:00+00:00,90.0,133.0,49.0,9.0,33.0,318.0,12.0,33.0,49.0,3.0,35.0,0.0,1.0,1.0,0.0,26.0,21.0,9.0,6.0,0.0,0.0,0.0,1.0,8.0,1.0,0.0,2.0,149.0,0.0,0.0,1.0,,6.0,7.0,1.0,5.0,3.0,11.0,4.0,1.0,2.0,13.0,2.0,5.0,64.0,3.0,1.0,16.0,4.0,0.0,1.0,59.0,1.0,14.0,0.0,4.0,3.0,2.0,23.0,0.0,0.0,0.0,0.0,4.0,0.0,2.0,19.0,0.0,0.0,4.0,9.0,0.0,19.0,0.0,0.0,4.0,0.0,40.0,2.0,1.0,0.0,1.0,0.0,0.0,120.0,0.0,1.0,,466.0,12.0,0.0,1.0,1.0,,0.0,0.0,2.0,0.0,1.0,2.0,3.0,45.0,0.0,0.0,13.0,4.0,23.0,5.0,0.0,4.0,20.0,59.0,2.0,0.0,1.0,29.0,166.0,,117.0,0.0,0.0,0.0,0.0,0.0,0.0,0.0,0.0,3.0,0.0,0.0,3.0,0.0,0.0,2.0,0.0
2025-03-02 00:00:00+00:00,174.0,253.0,67.0,31.0,50.0,431.0,12.0,49.0,29.0,4.0,40.0,0.0,4.0,4.0,3.0,37.0,17.0,9.0,18.0,1.0,0.0,2.0,0.0,21.0,2.0,0.0,0.0,112.0,10.0,0.0,1.0,,7.0,3.0,2.0,2.0,3.0,14.0,2.0,6.0,1.0,12.0,1.0,6.0,72.0,1.0,3.0,16.0,2.0,2.0,1.0,62.0,0.0,13.0,1.0,2.0,6.0,0.0,39.0,0.0,7.0,0.0,1.0,4.0,1.0,1.0,25.0,0.0,1.0,8.0,9.0,0.0,12.0,0.0,1.0,3.0,0.0,47.0,0.0,4.0,0.0,9.0,0.0,0.0,126.0,1.0,1.0,,546.0,25.0,0.0,4.0,0.0,,1.0,1.0,1.0,0.0,0.0,3.0,0.0,80.0,0.0,0.0,9.0,5.0,45.0,3.0,3.0,1.0,0.0,90.0,6.0,0.0,2.0,50.0,229.0,,156.0,1.0,0.0,1.0,0.0,0.0,0.0,0.0,0.0,6.0,0.0,1.0,5.0,0.0,1.0,0.0,0.0
2025-03-03 00:00:00+00:00,100.0,221.0,40.0,39.0,86.0,420.0,28.0,38.0,35.0,2.0,42.0,1.0,4.0,3.0,2.0,15.0,28.0,6.0,4.0,1.0,0.0,1.0,16.0,13.0,2.0,0.0,3.0,110.0,6.0,0.0,0.0,,14.0,6.0,6.0,2.0,8.0,14.0,1.0,4.0,1.0,18.0,1.0,3.0,86.0,2.0,3.0,15.0,7.0,0.0,2.0,73.0,0.0,20.0,0.0,0.0,2.0,3.0,27.0,0.0,1.0,1.0,5.0,3.0,2.0,0.0,27.0,2.0,1.0,3.0,6.0,2.0,19.0,1.0,2.0,2.0,0.0,39.0,0.0,2.0,2.0,2.0,0.0,0.0,155.0,0.0,6.0,,553.0,21.0,1.0,4.0,0.0,,1.0,2.0,11.0,0.0,2.0,2.0,4.0,59.0,1.0,1.0,9.0,6.0,54.0,3.0,4.0,2.0,2.0,110.0,6.0,1.0,0.0,45.0,242.0,,143.0,4.0,0.0,1.0,0.0,0.0,0.0,1.0,0.0,7.0,0.0,1.0,1.0,0.0,0.0,2.0,0.0
2025-03-04 00:00:00+00:00,124.0,187.0,59.0,68.0,42.0,477.0,10.0,49.0,36.0,2.0,29.0,3.0,7.0,2.0,1.0,96.0,18.0,8.0,4.0,0.0,0.0,1.0,6.0,16.0,8.0,1.0,2.0,94.0,5.0,3.0,1.0,,9.0,5.0,17.0,0.0,5.0,11.0,8.0,12.0,0.0,17.0,1.0,3.0,55.0,0.0,3.0,15.0,4.0,0.0,6.0,99.0,0.0,21.0,3.0,1.0,8.0,1.0,35.0,1.0,2.0,3.0,1.0,3.0,2.0,2.0,24.0,3.0,2.0,1.0,8.0,0.0,20.0,0.0,1.0,4.0,1.0,56.0,2.0,0.0,0.0,2.0,0.0,0.0,103.0,0.0,7.0,,612.0,18.0,0.0,6.0,2.0,,3.0,0.0,12.0,2.0,4.0,1.0,4.0,68.0,3.0,2.0,38.0,9.0,39.0,3.0,7.0,3.0,3.0,140.0,7.0,1.0,0.0,39.0,232.0,,163.0,1.0,0.0,1.0,2.0,0.0,0.0,1.0,0.0,8.0,6.0,2.0,3.0,0.0,0.0,4.0,0.0
2025-03-05 00:00:00+00:00,186.0,177.0,61.0,92.0,90.0,392.0,28.0,36.0,49.0,9.0,22.0,0.0,3.0,4.0,6.0,24.0,34.0,9.0,2.0,0.0,0.0,3.0,3.0,20.0,1.0,0.0,1.0,100.0,6.0,0.0,2.0,,4.0,2.0,0.0,1.0,7.0,14.0,2.0,6.0,1.0,23.0,7.0,5.0,79.0,1.0,1.0,20.0,3.0,0.0,0.0,83.0,0.0,17.0,0.0,1.0,3.0,0.0,30.0,0.0,0.0,3.0,0.0,3.0,1.0,1.0,16.0,1.0,0.0,5.0,9.0,0.0,15.0,0.0,2.0,8.0,32.0,64.0,2.0,1.0,1.0,1.0,0.0,0.0,123.0,0.0,5.0,,583.0,14.0,0.0,7.0,0.0,,15.0,0.0,0.0,1.0,5.0,1.0,4.0,48.0,1.0,0.0,18.0,6.0,46.0,5.0,4.0,2.0,0.0,166.0,1.0,0.0,0.0,36.0,270.0,,145.0,1.0,0.0,0.0,0.0,0.0,0.0,0.0,0.0,4.0,6.0,1.0,7.0,0.0,2.0,3.0,0.0
2025-03-06 00:00:00+00:00,134.0,187.0,113.0,39.0,114.0,415.0,49.0,53.0,21.0,17.0,20.0,0.0,14.0,9.0,3.0,17.0,12.0,17.0,4.0,0.0,0.0,3.0,7.0,20.0,1.0,0.0,1.0,89.0,0.0,6.0,0.0,,4.0,8.0,2.0,1.0,7.0,9.0,5.0,5.0,1.0,9.0,2.0,5.0,60.0,2.0,3.0,19.0,3.0,0.0,1.0,63.0,0.0,3.0,0.0,0.0,4.0,6.0,31.0,0.0,0.0,1.0,1.0,2.0,0.0,1.0,25.0,0.0,3.0,9.0,17.0,0.0,20.0,0.0,3.0,4.0,48.0,28.0,2.0,1.0,1.0,8.0,0.0,0.0,108.0,0.0,1.0,,536.0,9.0,0.0,3.0,0.0,,4.0,3.0,3.0,1.0,3.0,1.0,2.0,77.0,1.0,2.0,21.0,15.0,34.0,1.0,4.0,3.0,2.0,148.0,4.0,1.0,0.0,32.0,189.0,,126.0,2.0,1.0,0.0,0.0,0.0,0.0,3.0,0.0,1.0,13.0,0.0,5.0,1.0,2.0,1.0,0.0
2025-03-07 00:00:00+00:00,144.0,204.0,53.0,42.0,86.0,425.0,23.0,45.0,33.0,5.0,40.0,1.0,7.0,5.0,4.0,11.0,11.0,9.0,6.0,0.0,0.0,8.0,9.0,2.0,4.0,0.0,0.0,73.0,0.0,1.0,0.0,,10.0,2.0,3.0,2.0,9.0,6.0,2.0,4.0,3.0,18.0,0.0,3.0,76.0,2.0,1.0,25.0,2.0,1.0,2.0,90.0,0.0,17.0,1.0,1.0,7.0,1.0,34.0,0.0,0.0,0.0,1.0,2.0,0.0,3.0,28.0,0.0,2.0,19.0,9.0,0.0,15.0,0.0,1.0,1.0,46.0,64.0,3.0,0.0,1.0,1.0,0.0,0.0,146.0,0.0,2.0,,530.0,20.0,0.0,3.0,0.0,,2.0,2.0,1.0,3.0,5.0,8.0,3.0,70.0,0.0,0.0,14.0,9.0,40.0,2.0,7.0,3.0,1.0,93.0,5.0,0.0,0.0,23.0,236.0,,149.0,1.0,1.0,0.0,0.0,0.0,0.0,0.0,0.0,3.0,4.0,0.0,10.0,1.0,2.0,2.0,0.0
2025-03-08 00:00:00+00:00,122.0,178.0,34.0,9.0,26.0,349.0,16.0,43.0,15.0,1.0,18.0,3.0,7.0,1.0,4.0,13.0,8.0,4.0,5.0,0.0,0.0,2.0,5.0,6.0,0.0,0.0,0.0,89.0,2.0,2.0,2.0,,5.0,4.0,2.0,2.0,1.0,8.0,4.0,3.0,1.0,13.0,7.0,1.0,59.0,1.0,1.0,22.0,3.0,0.0,1.0,53.0,0.0,12.0,1.0,0.0,2.0,0.0,22.0,0.0,1.0,0.0,1.0,0.0,5.0,1.0,17.0,0.0,2.0,8.0,4.0,0.0,12.0,0.0,0.0,0.0,6.0,62.0,0.0,0.0,0.0,0.0,0.0,0.0,120.0,0.0,1.0,,433.0,12.0,0.0,3.0,0.0,,1.0,0.0,1.0,1.0,1.0,51.0,4.0,67.0,0.0,0.0,12.0,2.0,34.0,5.0,0.0,2.0,0.0,78.0,3.0,0.0,0.0,23.0,204.0,,114.0,0.0,0.0,0.0,0.0,0.0,0.0,0.0,0.0,3.0,1.0,0.0,6.0,0.0,0.0,0.0,0.0
2025-03-09 00:00:00+00:00,114.0,149.0,41.0,32.0,44.0,368.0,13.0,44.0,36.0,5.0,28.0,1.0,2.0,1.0,3.0,31.0,13.0,2.0,1.0,0.0,0.0,12.0,6.0,34.0,2.0,0.0,1.0,71.0,7.0,4.0,0.0,,4.0,5.0,1.0,0.0,6.0,10.0,2.0,4.0,0.0,15.0,1.0,1.0,56.0,1.0,2.0,11.0,2.0,0.0,0.0,66.0,0.0,15.0,0.0,2.0,2.0,2.0,24.0,0.0,2.0,0.0,2.0,2.0,1.0,2.0,26.0,0.0,1.0,6.0,2.0,0.0,14.0,0.0,0.0,0.0,14.0,56.0,9.0,0.0,0.0,0.0,0.0,0.0,140.0,0.0,1.0,,436.0,21.0,0.0,1.0,0.0,,0.0,2.0,1.0,0.0,1.0,27.0,1.0,53.0,1.0,1.0,13.0,3.0,46.0,0.0,3.0,1.0,0.0,85.0,2.0,1.0,0.0,35.0,239.0,,138.0,0.0,0.0,0.0,0.0,0.0,1.0,0.0,0.0,3.0,1.0,0.0,2.0,0.0,0.0,0.0,0.0
2025-03-10 00:00:00+00:00,110.0,234.0,34.0,32.0,46.0,465.0,27.0,55.0,24.0,4.0,33.0,2.0,2.0,4.0,7.0,22.0,6.0,3.0,4.0,1.0,0.0,7.0,3.0,22.0,1.0,0.0,3.0,94.0,2.0,1.0,2.0,,5.0,5.0,3.0,1.0,2.0,20.0,4.0,10.0,3.0,22.0,1.0,2.0,98.0,2.0,1.0,25.0,1.0,0.0,1.0,228.0,1.0,12.0,0.0,1.0,3.0,0.0,35.0,0.0,5.0,1.0,0.0,3.0,1.0,3.0,22.0,0.0,0.0,10.0,3.0,0.0,21.0,0.0,3.0,3.0,4.0,112.0,4.0,3.0,0.0,3.0,0.0,0.0,92.0,0.0,0.0,,533.0,16.0,0.0,7.0,1.0,,5.0,1.0,0.0,5.0,2.0,2.0,4.0,89.0,1.0,1.0,14.0,5.0,49.0,2.0,5.0,7.0,3.0,117.0,6.0,0.0,1.0,48.0,286.0,,142.0,3.0,0.0,2.0,0.0,0.0,1.0,0.0,0.0,5.0,4.0,0.0,10.0,0.0,0.0,0.0,0.0
2025-03-11 00:00:00+00:00,112.0,168.0,38.0,25.0,41.0,436.0,30.0,68.0,17.0,6.0,26.0,3.0,1.0,4.0,6.0,9.0,34.0,5.0,2.0,0.0,0.0,0.0,1.0,21.0,2.0,0.0,3.0,109.0,6.0,2.0,0.0,,5.0,1.0,1.0,3.0,7.0,12.0,5.0,4.0,1.0,22.0,3.0,1.0,79.0,1.0,0.0,32.0,3.0,0.0,1.0,141.0,0.0,19.0,4.0,7.0,6.0,0.0,40.0,1.0,1.0,0.0,1.0,5.0,3.0,1.0,21.0,1.0,1.0,6.0,5.0,0.0,17.0,1.0,2.0,1.0,12.0,75.0,7.0,1.0,2.0,5.0,0.0,1.0,107.0,0.0,1.0,,471.0,23.0,1.0,3.0,0.0,,3.0,0.0,3.0,4.0,3.0,1.0,2.0,79.0,2.0,1.0,31.0,9.0,32.0,3.0,3.0,2.0,0.0,130.0,3.0,0.0,1.0,29.0,231.0,,123.0,3.0,0.0,2.0,0.0,0.0,1.0,0.0,1.0,5.0,7.0,0.0,7.0,0.0,1.0,1.0,0.0
2025-03-12 00:00:00+00:00,102.0,234.0,51.0,20.0,45.0,424.0,14.0,37.0,29.0,2.0,18.0,0.0,10.0,6.0,3.0,15.0,23.0,15.0,0.0,1.0,0.0,1.0,2.0,7.0,2.0,0.0,3.0,127.0,1.0,1.0,1.0,,13.0,6.0,11.0,0.0,1.0,9.0,7.0,3.0,2.0,19.0,2.0,5.0,59.0,0.0,0.0,37.0,1.0,0.0,4.0,179.0,1.0,14.0,1.0,1.0,5.0,7.0,34.0,1.0,0.0,1.0,3.0,5.0,1.0,0.0,16.0,1.0,2.0,4.0,15.0,0.0,22.0,0.0,0.0,5.0,3.0,104.0,4.0,1.0,1.0,1.0,0.0,0.0,138.0,0.0,2.0,,506.0,15.0,2.0,6.0,0.0,,0.0,2.0,1.0,6.0,2.0,4.0,2.0,49.0,2.0,0.0,33.0,7.0,42.0,9.0,0.0,3.0,2.0,100.0,6.0,0.0,0.0,41.0,240.0,,115.0,4.0,1.0,3.0,0.0,1.0,1.0,0.0,0.0,2.0,3.0,1.0,5.0,0.0,1.0,0.0,0.0
2025-03-13 00:00:00+00:00,78.0,187.0,40.0,30.0,17.0,416.0,13.0,27.0,20.0,4.0,16.0,0.0,8.0,6.0,4.0,18.0,22.0,5.0,5.0,1.0,0.0,4.0,5.0,11.0,5.0,1.0,2.0,123.0,4.0,0.0,0.0,,4.0,5.0,0.0,3.0,3.0,16.0,3.0,1.0,3.0,17.0,1.0,4.0,46.0,1.0,0.0,21.0,2.0,1.0,1.0,71.0,0.0,12.0,0.0,1.0,5.0,6.0,26.0,1.0,0.0,0.0,5.0,1.0,1.0,1.0,27.0,2.0,1.0,12.0,5.0,1.0,20.0,1.0,1.0,0.0,4.0,57.0,4.0,1.0,1.0,7.0,0.0,0.0,122.0,0.0,2.0,,480.0,19.0,0.0,1.0,0.0,,2.0,2.0,2.0,9.0,4.0,1.0,1.0,56.0,0.0,0.0,13.0,7.0,25.0,4.0,1.0,5.0,0.0,118.0,2.0,1.0,0.0,34.0,174.0,,104.0,3.0,0.0,1.0,1.0,0.0,1.0,1.0,3.0,3.0,5.0,0.0,8.0,1.0,1.0,1.0,0.0
2025-03-14 00:00:00+00:00,111.0,146.0,35.0,13.0,50.0,349.0,25.0,22.0,31.0,4.0,28.0,1.0,3.0,3.0,4.0,26.0,26.0,4.0,2.0,3.0,0.0,2.0,1.0,8.0,3.0,0.0,0.0,104.0,9.0,0.0,1.0,,9.0,8.0,0.0,3.0,6.0,7.0,2.0,3.0,3.0,18.0,4.0,4.0,50.0,1.0,2.0,24.0,4.0,1.0,2.0,69.0,0.0,18.0,2.0,1.0,4.0,3.0,38.0,0.0,0.0,0.0,1.0,1.0,0.0,0.0,19.0,0.0,0.0,3.0,4.0,2.0,16.0,0.0,1.0,0.0,4.0,69.0,4.0,5.0,1.0,15.0,0.0,0.0,148.0,0.0,5.0,,436.0,12.0,0.0,0.0,0.0,,0.0,4.0,2.0,2.0,2.0,3.0,3.0,74.0,1.0,1.0,18.0,16.0,51.0,4.0,2.0,0.0,0.0,90.0,1.0,0.0,7.0,39.0,211.0,,117.0,0.0,0.0,2.0,0.0,0.0,2.0,0.0,1.0,4.0,6.0,0.0,8.0,0.0,0.0,2.0,0.0
2025-03-15 00:00:00+00:00,115.0,135.0,34.0,20.0,34.0,286.0,5.0,32.0,41.0,5.0,22.0,1.0,3.0,4.0,1.0,14.0,19.0,4.0,4.0,0.0,0.0,4.0,0.0,29.0,1.0,0.0,0.0,59.0,13.0,1.0,0.0,,6.0,3.0,1.0,4.0,4.0,14.0,2.0,3.0,1.0,11.0,1.0,4.0,33.0,2.0,0.0,4.0,1.0,0.0,0.0,60.0,1.0,30.0,0.0,5.0,1.0,0.0,22.0,0.0,0.0,0.0,0.0,1.0,2.0,0.0,22.0,0.0,1.0,7.0,4.0,0.0,15.0,0.0,0.0,2.0,2.0,42.0,2.0,3.0,3.0,31.0,0.0,0.0,135.0,0.0,3.0,,428.0,12.0,0.0,4.0,0.0,,0.0,0.0,2.0,0.0,1.0,1.0,1.0,46.0,1.0,0.0,12.0,3.0,31.0,0.0,1.0,2.0,0.0,61.0,2.0,0.0,0.0,25.0,130.0,,100.0,0.0,0.0,0.0,0.0,0.0,1.0,0.0,0.0,0.0,0.0,1.0,3.0,0.0,1.0,0.0,0.0
2025-03-16 00:00:00+00:00,93.0,186.0,25.0,48.0,24.0,295.0,3.0,34.0,12.0,5.0,26.0,0.0,1.0,3.0,0.0,10.0,12.0,6.0,3.0,0.0,0.0,0.0,1.0,2.0,0.0,0.0,1.0,67.0,1.0,0.0,0.0,,7.0,2.0,2.0,3.0,4.0,7.0,1.0,5.0,2.0,15.0,0.0,2.0,38.0,1.0,0.0,3.0,0.0,2.0,0.0,73.0,0.0,21.0,0.0,0.0,1.0,0.0,21.0,0.0,0.0,0.0,2.0,2.0,0.0,8.0,12.0,0.0,1.0,4.0,6.0,0.0,9.0,0.0,0.0,2.0,7.0,37.0,0.0,1.0,0.0,4.0,0.0,0.0,138.0,0.0,0.0,3.0,339.0,7.0,0.0,1.0,0.0,,0.0,0.0,2.0,0.0,0.0,2.0,1.0,45.0,0.0,0.0,5.0,4.0,37.0,1.0,4.0,0.0,0.0,64.0,4.0,0.0,0.0,30.0,104.0,,89.0,1.0,0.0,0.0,0.0,0.0,0.0,0.0,1.0,5.0,1.0,1.0,7.0,0.0,0.0,1.0,0.0
2025-03-17 00:00:00+00:00,104.0,195.0,40.0,48.0,38.0,336.0,30.0,31.0,27.0,14.0,28.0,1.0,7.0,15.0,5.0,10.0,25.0,6.0,0.0,2.0,0.0,1.0,2.0,19.0,6.0,0.0,7.0,101.0,2.0,0.0,0.0,,5.0,19.0,2.0,3.0,0.0,11.0,1.0,1.0,5.0,16.0,0.0,11.0,40.0,1.0,0.0,9.0,5.0,0.0,17.0,88.0,0.0,11.0,1.0,3.0,1.0,1.0,17.0,10.0,0.0,0.0,0.0,3.0,1.0,7.0,20.0,0.0,0.0,8.0,6.0,1.0,23.0,0.0,0.0,0.0,2.0,64.0,2.0,2.0,1.0,5.0,0.0,0.0,148.0,0.0,5.0,7.0,421.0,15.0,0.0,6.0,0.0,,2.0,1.0,2.0,0.0,1.0,6.0,1.0,47.0,0.0,1.0,21.0,11.0,31.0,3.0,0.0,6.0,0.0,62.0,6.0,0.0,2.0,29.0,117.0,,81.0,1.0,0.0,2.0,0.0,0.0,0.0,0.0,1.0,5.0,4.0,0.0,9.0,0.0,1.0,1.0,0.0
2025-03-18 00:00:00+00:00,92.0,176.0,39.0,24.0,47.0,278.0,35.0,34.0,16.0,7.0,52.0,3.0,11.0,10.0,7.0,7.0,13.0,4.0,5.0,3.0,0.0,5.0,0.0,8.0,1.0,0.0,6.0,106.0,2.0,2.0,2.0,,2.0,5.0,1.0,0.0,2.0,5.0,4.0,22.0,5.0,20.0,0.0,4.0,36.0,1.0,3.0,13.0,3.0,0.0,35.0,90.0,0.0,20.0,3.0,2.0,3.0,5.0,15.0,7.0,0.0,0.0,2.0,1.0,0.0,4.0,10.0,2.0,3.0,6.0,4.0,2.0,5.0,1.0,0.0,0.0,5.0,95.0,1.0,0.0,1.0,1.0,0.0,0.0,110.0,0.0,3.0,2.0,439.0,5.0,1.0,2.0,0.0,,0.0,2.0,0.0,1.0,2.0,3.0,0.0,42.0,1.0,0.0,18.0,4.0,34.0,4.0,1.0,5.0,0.0,91.0,2.0,0.0,0.0,42.0,142.0,,70.0,3.0,0.0,0.0,0.0,0.0,0.0,2.0,4.0,5.0,4.0,0.0,9.0,0.0,1.0,1.0,0.0
2025-03-19 00:00:00+00:00,65.0,202.0,53.0,24.0,41.0,319.0,9.0,56.0,16.0,27.0,88.0,3.0,0.0,8.0,10.0,24.0,29.0,7.0,2.0,2.0,0.0,1.0,2.0,15.0,1.0,0.0,4.0,94.0,15.0,2.0,9.0,,9.0,2.0,0.0,3.0,4.0,4.0,5.0,19.0,6.0,14.0,1.0,7.0,47.0,3.0,0.0,10.0,6.0,0.0,5.0,76.0,0.0,15.0,2.0,0.0,5.0,1.0,19.0,1.0,1.0,1.0,2.0,3.0,2.0,1.0,17.0,0.0,0.0,1.0,7.0,1.0,5.0,0.0,0.0,2.0,1.0,46.0,2.0,0.0,0.0,5.0,0.0,0.0,160.0,1.0,2.0,5.0,467.0,6.0,0.0,4.0,0.0,,0.0,1.0,0.0,1.0,2.0,0.0,0.0,71.0,2.0,0.0,10.0,6.0,37.0,1.0,3.0,0.0,0.0,99.0,4.0,0.0,1.0,33.0,174.0,,65.0,1.0,1.0,0.0,0.0,1.0,2.0,0.0,0.0,5.0,2.0,0.0,5.0,0.0,4.0,2.0,0.0
2025-03-20 00:00:00+00:00,72.0,188.0,67.0,14.0,28.0,400.0,11.0,31.0,19.0,7.0,73.0,3.0,7.0,6.0,5.0,25.0,37.0,6.0,18.0,1.0,0.0,0.0,3.0,9.0,7.0,0.0,5.0,90.0,7.0,6.0,5.0,,5.0,5.0,12.0,1.0,1.0,12.0,3.0,8.0,8.0,16.0,1.0,6.0,48.0,0.0,0.0,18.0,3.0,0.0,2.0,58.0,0.0,10.0,2.0,4.0,7.0,3.0,26.0,2.0,0.0,0.0,1.0,1.0,2.0,0.0,42.0,1.0,0.0,5.0,6.0,0.0,10.0,0.0,3.0,4.0,0.0,55.0,2.0,1.0,2.0,1.0,0.0,0.0,57.0,0.0,1.0,3.0,471.0,11.0,0.0,4.0,0.0,,1.0,0.0,0.0,0.0,4.0,0.0,5.0,62.0,0.0,1.0,18.0,5.0,48.0,2.0,0.0,4.0,2.0,76.0,5.0,0.0,1.0,35.0,204.0,,109.0,2.0,1.0,1.0,0.0,0.0,0.0,0.0,2.0,5.0,8.0,0.0,5.0,0.0,15.0,1.0,0.0
2025-03-21 00:00:00+00:00,98.0,172.0,45.0,26.0,35.0,386.0,15.0,32.0,6.0,2.0,44.0,2.0,2.0,7.0,3.0,19.0,21.0,7.0,4.0,3.0,0.0,2.0,4.0,11.0,5.0,0.0,13.0,114.0,10.0,5.0,2.0,,7.0,4.0,2.0,86.0,4.0,12.0,1.0,2.0,2.0,11.0,2.0,8.0,45.0,5.0,3.0,29.0,6.0,0.0,4.0,69.0,0.0,13.0,0.0,3.0,5.0,6.0,39.0,0.0,0.0,2.0,3.0,1.0,1.0,2.0,23.0,0.0,2.0,6.0,7.0,1.0,5.0,0.0,3.0,1.0,2.0,69.0,3.0,0.0,0.0,0.0,0.0,0.0,180.0,0.0,2.0,2.0,444.0,18.0,0.0,5.0,0.0,,2.0,2.0,2.0,1.0,2.0,1.0,4.0,36.0,2.0,1.0,14.0,12.0,50.0,2.0,1.0,2.0,2.0,85.0,2.0,0.0,0.0,26.0,170.0,,134.0,1.0,1.0,1.0,0.0,0.0,2.0,0.0,1.0,3.0,3.0,0.0,8.0,1.0,2.0,10.0,0.0
2025-03-22 00:00:00+00:00,73.0,140.0,30.0,22.0,12.0,317.0,12.0,34.0,13.0,4.0,20.0,4.0,4.0,17.0,2.0,16.0,19.0,3.0,3.0,0.0,0.0,1.0,1.0,6.0,2.0,0.0,2.0,86.0,11.0,2.0,2.0,,3.0,1.0,2.0,27.0,3.0,4.0,0.0,2.0,0.0,13.0,2.0,3.0,44.0,0.0,0.0,21.0,3.0,0.0,40.0,134.0,0.0,7.0,0.0,2.0,0.0,0.0,20.0,1.0,0.0,1.0,1.0,2.0,0.0,1.0,19.0,0.0,0.0,6.0,3.0,0.0,16.0,0.0,2.0,2.0,0.0,30.0,1.0,1.0,0.0,0.0,0.0,0.0,113.0,0.0,3.0,5.0,380.0,9.0,0.0,8.0,0.0,,2.0,2.0,5.0,1.0,1.0,0.0,1.0,34.0,1.0,1.0,11.0,4.0,28.0,4.0,2.0,1.0,0.0,74.0,0.0,0.0,0.0,33.0,153.0,,81.0,0.0,0.0,0.0,0.0,0.0,0.0,0.0,0.0,1.0,4.0,0.0,7.0,0.0,1.0,13.0,0.0
2025-03-23 00:00:00+00:00,67.0,124.0,44.0,9.0,77.0,317.0,9.0,18.0,9.0,3.0,24.0,21.0,5.0,8.0,3.0,17.0,11.0,1.0,5.0,1.0,0.0,2.0,1.0,6.0,1.0,0.0,0.0,73.0,5.0,1.0,1.0,,5.0,0.0,1.0,10.0,5.0,3.0,2.0,2.0,4.0,12.0,6.0,3.0,37.0,2.0,0.0,17.0,0.0,1.0,17.0,48.0,0.0,8.0,2.0,3.0,3.0,0.0,25.0,0.0,1.0,0.0,2.0,6.0,1.0,2.0,32.0,0.0,1.0,5.0,1.0,2.0,9.0,0.0,1.0,0.0,5.0,58.0,1.0,1.0,0.0,1.0,0.0,0.0,115.0,0.0,0.0,1.0,390.0,9.0,0.0,0.0,0.0,,2.0,2.0,0.0,0.0,0.0,2.0,0.0,39.0,0.0,0.0,7.0,4.0,28.0,2.0,1.0,1.0,0.0,61.0,2.0,0.0,0.0,24.0,133.0,,113.0,0.0,0.0,0.0,0.0,0.0,0.0,0.0,0.0,0.0,5.0,1.0,5.0,0.0,2.0,10.0,0.0
2025-03-24 00:00:00+00:00,163.0,156.0,41.0,29.0,53.0,337.0,19.0,46.0,36.0,1.0,48.0,3.0,6.0,9.0,1.0,22.0,21.0,36.0,17.0,1.0,0.0,2.0,6.0,13.0,0.0,0.0,9.0,105.0,11.0,1.0,0.0,,5.0,4.0,1.0,17.0,5.0,11.0,0.0,6.0,4.0,17.0,5.0,11.0,48.0,11.0,3.0,23.0,6.0,2.0,12.0,71.0,0.0,6.0,3.0,2.0,1.0,0.0,16.0,1.0,1.0,0.0,8.0,1.0,1.0,0.0,19.0,2.0,0.0,7.0,36.0,2.0,14.0,1.0,3.0,1.0,2.0,69.0,6.0,1.0,0.0,3.0,0.0,0.0,205.0,1.0,2.0,5.0,578.0,13.0,0.0,2.0,1.0,,2.0,5.0,1.0,1.0,3.0,4.0,5.0,52.0,0.0,0.0,14.0,6.0,32.0,1.0,1.0,1.0,2.0,89.0,9.0,0.0,1.0,41.0,196.0,,108.0,1.0,0.0,1.0,0.0,0.0,0.0,0.0,2.0,4.0,0.0,0.0,12.0,1.0,3.0,4.0,0.0
2025-03-25 00:00:00+00:00,136.0,182.0,39.0,22.0,34.0,357.0,20.0,71.0,23.0,4.0,42.0,2.0,6.0,6.0,3.0,15.0,22.0,15.0,7.0,2.0,0.0,3.0,2.0,17.0,3.0,0.0,1.0,127.0,5.0,2.0,0.0,,10.0,2.0,4.0,8.0,0.0,9.0,0.0,11.0,6.0,16.0,3.0,12.0,66.0,6.0,2.0,27.0,2.0,1.0,8.0,53.0,0.0,17.0,0.0,1.0,3.0,2.0,40.0,0.0,0.0,3.0,5.0,1.0,0.0,1.0,37.0,3.0,3.0,21.0,15.0,0.0,7.0,0.0,4.0,4.0,0.0,57.0,1.0,1.0,1.0,2.0,0.0,0.0,94.0,0.0,1.0,5.0,476.0,12.0,0.0,1.0,0.0,,0.0,2.0,4.0,1.0,2.0,3.0,0.0,56.0,1.0,1.0,16.0,5.0,42.0,4.0,0.0,2.0,2.0,80.0,5.0,0.0,1.0,39.0,175.0,,108.0,9.0,0.0,0.0,0.0,0.0,0.0,0.0,1.0,9.0,15.0,0.0,7.0,0.0,4.0,2.0,1.0
2025-03-26 00:00:00+00:00,198.0,469.0,38.0,24.0,34.0,385.0,15.0,50.0,38.0,7.0,36.0,2.0,4.0,7.0,5.0,15.0,20.0,6.0,11.0,4.0,0.0,1.0,5.0,10.0,8.0,0.0,2.0,149.0,22.0,1.0,3.0,,1.0,7.0,2.0,5.0,3.0,10.0,4.0,9.0,9.0,25.0,0.0,5.0,68.0,1.0,1.0,51.0,1.0,1.0,3.0,47.0,0.0,12.0,0.0,15.0,4.0,0.0,21.0,0.0,0.0,1.0,2.0,2.0,0.0,2.0,26.0,3.0,1.0,22.0,6.0,0.0,14.0,1.0,1.0,1.0,1.0,40.0,5.0,2.0,1.0,3.0,0.0,0.0,148.0,0.0,1.0,7.0,473.0,7.0,2.0,3.0,0.0,,1.0,0.0,1.0,0.0,2.0,10.0,2.0,69.0,0.0,1.0,17.0,14.0,48.0,3.0,2.0,3.0,0.0,97.0,2.0,0.0,0.0,35.0,180.0,,113.0,5.0,1.0,1.0,0.0,0.0,4.0,0.0,0.0,3.0,23.0,0.0,9.0,0.0,1.0,0.0,0.0
2025-03-27 00:00:00+00:00,151.0,287.0,44.0,16.0,26.0,334.0,14.0,42.0,21.0,5.0,53.0,7.0,6.0,15.0,4.0,7.0,29.0,8.0,4.0,0.0,1.0,4.0,1.0,3.0,1.0,0.0,2.0,105.0,5.0,1.0,0.0,,3.0,5.0,1.0,19.0,5.0,8.0,2.0,3.0,3.0,21.0,5.0,9.0,61.0,2.0,1.0,31.0,6.0,1.0,3.0,48.0,0.0,10.0,2.0,1.0,7.0,0.0,25.0,1.0,0.0,0.0,0.0,2.0,3.0,2.0,33.0,1.0,5.0,9.0,8.0,0.0,11.0,1.0,5.0,3.0,1.0,50.0,2.0,6.0,0.0,2.0,0.0,0.0,93.0,0.0,2.0,3.0,459.0,15.0,0.0,3.0,0.0,,1.0,2.0,0.0,4.0,3.0,2.0,1.0,57.0,0.0,0.0,19.0,8.0,48.0,1.0,10.0,2.0,2.0,90.0,1.0,0.0,2.0,45.0,179.0,,105.0,7.0,0.0,0.0,0.0,0.0,0.0,0.0,1.0,2.0,11.0,0.0,15.0,1.0,1.0,2.0,0.0
2025-03-28 00:00:00+00:00,146.0,231.0,39.0,32.0,39.0,310.0,5.0,30.0,21.0,5.0,18.0,6.0,6.0,10.0,4.0,23.0,14.0,8.0,27.0,0.0,0.0,3.0,4.0,4.0,3.0,1.0,4.0,98.0,1.0,2.0,4.0,,1.0,1.0,2.0,22.0,8.0,2.0,0.0,1.0,4.0,13.0,4.0,1.0,52.0,1.0,3.0,25.0,1.0,1.0,8.0,57.0,0.0,10.0,2.0,6.0,3.0,0.0,23.0,0.0,0.0,2.0,2.0,1.0,3.0,0.0,18.0,1.0,1.0,4.0,8.0,0.0,19.0,0.0,2.0,3.0,0.0,56.0,1.0,4.0,0.0,9.0,0.0,0.0,102.0,0.0,3.0,5.0,416.0,5.0,0.0,2.0,0.0,,0.0,3.0,2.0,0.0,1.0,1.0,0.0,53.0,0.0,0.0,15.0,15.0,89.0,2.0,4.0,1.0,0.0,88.0,0.0,1.0,2.0,30.0,171.0,,121.0,11.0,0.0,0.0,0.0,0.0,0.0,0.0,0.0,3.0,2.0,0.0,7.0,1.0,2.0,2.0,0.0
2025-03-29 00:00:00+00:00,85.0,126.0,32.0,36.0,24.0,289.0,14.0,47.0,21.0,0.0,24.0,2.0,5.0,6.0,1.0,4.0,12.0,3.0,5.0,0.0,0.0,3.0,1.0,7.0,2.0,2.0,3.0,113.0,2.0,1.0,1.0,,4.0,6.0,2.0,2.0,2.0,12.0,2.0,4.0,3.0,13.0,2.0,1.0,49.0,1.0,0.0,13.0,1.0,0.0,0.0,33.0,0.0,19.0,3.0,1.0,7.0,1.0,25.0,10.0,0.0,0.0,0.0,1.0,0.0,1.0,18.0,3.0,1.0,8.0,3.0,0.0,14.0,0.0,0.0,1.0,0.0,48.0,2.0,3.0,0.0,1.0,0.0,0.0,78.0,0.0,0.0,5.0,421.0,15.0,0.0,0.0,1.0,,0.0,1.0,1.0,2.0,1.0,2.0,10.0,36.0,0.0,0.0,10.0,4.0,338.0,5.0,5.0,9.0,0.0,58.0,2.0,0.0,1.0,22.0,134.0,,93.0,6.0,0.0,0.0,0.0,0.0,0.0,0.0,0.0,3.0,5.0,0.0,1.0,0.0,0.0,2.0,0.0
2025-03-30 00:00:00+00:00,53.0,117.0,22.0,17.0,15.0,264.0,8.0,44.0,17.0,2.0,23.0,0.0,2.0,1.0,1.0,9.0,12.0,8.0,1.0,0.0,0.0,2.0,0.0,10.0,3.0,1.0,2.0,88.0,5.0,0.0,1.0,,2.0,2.0,0.0,3.0,6.0,3.0,0.0,6.0,1.0,13.0,0.0,2.0,47.0,3.0,2.0,15.0,0.0,0.0,2.0,57.0,0.0,9.0,5.0,2.0,4.0,0.0,12.0,0.0,2.0,0.0,0.0,0.0,0.0,2.0,16.0,3.0,7.0,2.0,8.0,0.0,15.0,0.0,1.0,2.0,9.0,40.0,0.0,1.0,2.0,2.0,0.0,0.0,59.0,0.0,2.0,5.0,335.0,17.0,0.0,6.0,3.0,,0.0,0.0,3.0,0.0,2.0,1.0,7.0,29.0,1.0,1.0,6.0,4.0,150.0,1.0,1.0,1.0,0.0,54.0,4.0,0.0,0.0,20.0,144.0,,90.0,2.0,1.0,0.0,0.0,0.0,0.0,0.0,0.0,0.0,4.0,0.0,3.0,1.0,2.0,0.0,0.0
2025-03-31 00:00:00+00:00,88.0,152.0,55.0,19.0,29.0,339.0,16.0,30.0,21.0,2.0,26.0,3.0,2.0,8.0,4.0,13.0,18.0,13.0,5.0,1.0,0.0,2.0,0.0,4.0,2.0,0.0,3.0,141.0,2.0,1.0,4.0,,0.0,0.0,0.0,4.0,2.0,3.0,1.0,1.0,5.0,18.0,2.0,2.0,68.0,2.0,10.0,14.0,1.0,1.0,3.0,51.0,0.0,11.0,2.0,4.0,6.0,2.0,29.0,2.0,0.0,0.0,0.0,0.0,0.0,4.0,11.0,0.0,0.0,4.0,13.0,0.0,15.0,0.0,1.0,1.0,31.0,58.0,3.0,2.0,2.0,4.0,0.0,0.0,54.0,0.0,3.0,3.0,416.0,14.0,0.0,10.0,0.0,,0.0,1.0,4.0,1.0,3.0,2.0,21.0,41.0,0.0,0.0,18.0,8.0,126.0,2.0,1.0,9.0,0.0,95.0,5.0,0.0,1.0,31.0,153.0,,99.0,8.0,0.0,0.0,0.0,0.0,0.0,1.0,1.0,1.0,3.0,0.0,5.0,0.0,1.0,1.0,0.0
2025-04-01 00:00:00+00:00,82.0,206.0,37.0,18.0,62.0,300.0,8.0,34.0,22.0,6.0,36.0,13.0,1.0,13.0,3.0,11.0,26.0,14.0,3.0,4.0,0.0,6.0,4.0,11.0,5.0,0.0,5.0,106.0,5.0,2.0,0.0,,6.0,5.0,3.0,3.0,6.0,11.0,2.0,2.0,6.0,17.0,4.0,4.0,47.0,3.0,0.0,29.0,2.0,1.0,16.0,75.0,0.0,7.0,3.0,2.0,4.0,3.0,30.0,1.0,1.0,0.0,1.0,1.0,0.0,3.0,35.0,1.0,0.0,10.0,14.0,3.0,10.0,1.0,1.0,2.0,24.0,64.0,4.0,4.0,1.0,3.0,0.0,0.0,142.0,0.0,3.0,4.0,480.0,19.0,0.0,2.0,1.0,,0.0,3.0,5.0,1.0,1.0,0.0,18.0,43.0,0.0,1.0,17.0,3.0,81.0,1.0,1.0,3.0,1.0,72.0,5.0,0.0,1.0,24.0,143.0,,92.0,10.0,0.0,3.0,0.0,1.0,0.0,0.0,1.0,6.0,5.0,0.0,6.0,0.0,4.0,6.0,0.0
2025-04-02 00:00:00+00:00,95.0,162.0,42.0,15.0,54.0,341.0,7.0,40.0,24.0,1.0,34.0,12.0,2.0,22.0,4.0,11.0,18.0,7.0,10.0,8.0,0.0,3.0,4.0,12.0,1.0,0.0,1.0,96.0,4.0,1.0,0.0,,9.0,3.0,0.0,3.0,3.0,4.0,0.0,1.0,6.0,15.0,1.0,2.0,46.0,1.0,0.0,20.0,4.0,2.0,2.0,51.0,0.0,14.0,0.0,5.0,3.0,1.0,21.0,2.0,0.0,1.0,1.0,2.0,2.0,1.0,21.0,1.0,0.0,8.0,7.0,3.0,7.0,1.0,0.0,1.0,3.0,58.0,1.0,0.0,0.0,2.0,0.0,0.0,74.0,0.0,4.0,3.0,424.0,9.0,0.0,7.0,1.0,,1.0,2.0,1.0,0.0,1.0,5.0,8.0,48.0,1.0,0.0,20.0,5.0,135.0,4.0,1.0,6.0,0.0,76.0,13.0,0.0,2.0,21.0,164.0,,117.0,3.0,0.0,2.0,0.0,0.0,3.0,1.0,0.0,3.0,3.0,0.0,6.0,1.0,2.0,6.0,0.0
2025-04-03 00:00:00+00:00,92.0,151.0,29.0,17.0,26.0,365.0,8.0,26.0,17.0,2.0,42.0,10.0,4.0,10.0,3.0,12.0,13.0,4.0,2.0,2.0,0.0,3.0,6.0,8.0,8.0,0.0,6.0,99.0,5.0,4.0,2.0,,5.0,3.0,0.0,7.0,2.0,18.0,0.0,0.0,3.0,18.0,3.0,4.0,64.0,1.0,1.0,24.0,2.0,1.0,1.0,55.0,0.0,10.0,6.0,8.0,1.0,0.0,35.0,1.0,0.0,0.0,4.0,3.0,0.0,1.0,35.0,0.0,2.0,3.0,4.0,3.0,12.0,0.0,3.0,6.0,1.0,61.0,4.0,0.0,2.0,3.0,0.0,0.0,136.0,0.0,0.0,4.0,363.0,14.0,0.0,3.0,0.0,,6.0,3.0,1.0,2.0,5.0,1.0,6.0,79.0,4.0,1.0,9.0,24.0,245.0,1.0,1.0,3.0,4.0,87.0,7.0,0.0,0.0,32.0,184.0,,163.0,1.0,0.0,1.0,1.0,0.0,2.0,1.0,0.0,1.0,5.0,0.0,7.0,1.0,3.0,0.0,0.0
2025-04-04 00:00:00+00:00,74.0,134.0,32.0,16.0,18.0,362.0,7.0,30.0,25.0,2.0,27.0,2.0,2.0,16.0,2.0,12.0,13.0,3.0,4.0,0.0,0.0,1.0,0.0,7.0,4.0,0.0,2.0,83.0,1.0,1.0,0.0,,3.0,4.0,7.0,4.0,4.0,23.0,1.0,1.0,7.0,27.0,1.0,7.0,115.0,4.0,0.0,25.0,3.0,1.0,0.0,48.0,0.0,13.0,3.0,9.0,4.0,0.0,17.0,0.0,1.0,0.0,3.0,1.0,1.0,4.0,11.0,0.0,0.0,7.0,3.0,1.0,6.0,0.0,2.0,3.0,11.0,69.0,6.0,1.0,0.0,6.0,0.0,0.0,163.0,0.0,1.0,6.0,382.0,13.0,0.0,0.0,0.0,,2.0,10.0,2.0,2.0,3.0,2.0,3.0,53.0,0.0,0.0,24.0,9.0,122.0,2.0,6.0,1.0,1.0,77.0,0.0,0.0,0.0,35.0,202.0,,113.0,3.0,0.0,0.0,0.0,0.0,1.0,0.0,2.0,3.0,3.0,0.0,6.0,2.0,4.0,1.0,0.0
2025-04-05 00:00:00+00:00,60.0,95.0,23.0,11.0,10.0,281.0,1.0,37.0,5.0,2.0,15.0,2.0,3.0,4.0,1.0,9.0,17.0,4.0,2.0,0.0,0.0,2.0,6.0,5.0,2.0,1.0,0.0,75.0,0.0,0.0,2.0,,2.0,5.0,7.0,1.0,2.0,9.0,1.0,1.0,1.0,8.0,0.0,0.0,47.0,0.0,0.0,15.0,6.0,0.0,1.0,59.0,0.0,22.0,2.0,3.0,1.0,1.0,12.0,0.0,0.0,3.0,2.0,2.0,0.0,2.0,15.0,0.0,1.0,0.0,4.0,1.0,3.0,1.0,0.0,4.0,7.0,34.0,5.0,0.0,2.0,6.0,0.0,0.0,129.0,0.0,4.0,3.0,351.0,19.0,0.0,0.0,2.0,,0.0,0.0,17.0,0.0,1.0,0.0,5.0,56.0,1.0,0.0,9.0,3.0,37.0,1.0,2.0,2.0,0.0,47.0,2.0,0.0,0.0,25.0,135.0,,103.0,0.0,1.0,0.0,0.0,0.0,1.0,1.0,0.0,2.0,1.0,1.0,4.0,1.0,5.0,2.0,0.0
2025-04-06 00:00:00+00:00,60.0,132.0,27.0,19.0,27.0,281.0,3.0,29.0,32.0,4.0,24.0,0.0,1.0,2.0,1.0,21.0,17.0,2.0,2.0,0.0,0.0,0.0,0.0,2.0,4.0,0.0,0.0,46.0,3.0,0.0,0.0,,2.0,5.0,1.0,1.0,1.0,9.0,2.0,3.0,4.0,22.0,1.0,1.0,64.0,1.0,0.0,13.0,8.0,0.0,0.0,68.0,0.0,12.0,0.0,15.0,4.0,1.0,22.0,0.0,0.0,2.0,3.0,0.0,0.0,0.0,19.0,0.0,1.0,3.0,2.0,0.0,14.0,0.0,0.0,1.0,2.0,62.0,3.0,0.0,0.0,11.0,0.0,0.0,136.0,0.0,2.0,2.0,386.0,9.0,0.0,0.0,0.0,,1.0,5.0,3.0,1.0,1.0,0.0,7.0,61.0,1.0,0.0,8.0,2.0,102.0,4.0,3.0,3.0,0.0,91.0,2.0,0.0,1.0,20.0,147.0,,116.0,4.0,0.0,2.0,0.0,0.0,0.0,0.0,0.0,3.0,1.0,0.0,2.0,0.0,5.0,1.0,0.0
2025-04-07 00:00:00+00:00,114.0,187.0,36.0,36.0,36.0,425.0,4.0,60.0,31.0,4.0,51.0,1.0,3.0,8.0,2.0,14.0,7.0,7.0,4.0,1.0,0.0,0.0,1.0,9.0,3.0,0.0,0.0,81.0,3.0,3.0,0.0,,4.0,1.0,2.0,21.0,5.0,22.0,3.0,1.0,7.0,30.0,4.0,2.0,86.0,5.0,0.0,19.0,1.0,0.0,0.0,49.0,0.0,12.0,0.0,1.0,4.0,0.0,30.0,1.0,1.0,0.0,3.0,1.0,1.0,0.0,30.0,1.0,4.0,6.0,7.0,0.0,13.0,1.0,1.0,2.0,3.0,78.0,8.0,0.0,2.0,3.0,0.0,0.0,133.0,0.0,0.0,3.0,474.0,28.0,0.0,2.0,0.0,,2.0,3.0,1.0,1.0,3.0,3.0,8.0,101.0,0.0,1.0,13.0,6.0,378.0,5.0,0.0,9.0,0.0,126.0,6.0,0.0,0.0,33.0,226.0,,171.0,1.0,0.0,1.0,0.0,0.0,0.0,2.0,2.0,4.0,5.0,0.0,6.0,0.0,0.0,0.0,0.0
2025-04-08 00:00:00+00:00,93.0,159.0,59.0,24.0,35.0,409.0,8.0,45.0,25.0,3.0,30.0,2.0,1.0,16.0,4.0,12.0,19.0,8.0,5.0,2.0,0.0,3.0,1.0,14.0,1.0,0.0,4.0,87.0,2.0,0.0,3.0,,2.0,5.0,3.0,2.0,7.0,12.0,0.0,3.0,3.0,20.0,4.0,2.0,94.0,3.0,0.0,15.0,6.0,0.0,0.0,43.0,0.0,17.0,1.0,2.0,3.0,6.0,28.0,0.0,0.0,1.0,1.0,43.0,0.0,3.0,21.0,2.0,1.0,5.0,8.0,0.0,11.0,0.0,4.0,1.0,0.0,68.0,5.0,0.0,0.0,10.0,0.0,0.0,127.0,0.0,3.0,0.0,433.0,18.0,0.0,0.0,0.0,,1.0,1.0,2.0,3.0,6.0,1.0,3.0,59.0,0.0,0.0,18.0,4.0,364.0,4.0,31.0,7.0,0.0,84.0,6.0,1.0,0.0,37.0,183.0,,140.0,1.0,0.0,0.0,0.0,0.0,0.0,1.0,2.0,0.0,5.0,0.0,7.0,0.0,3.0,0.0,0.0
2025-04-09 00:00:00+00:00,91.0,175.0,26.0,17.0,24.0,443.0,4.0,38.0,33.0,3.0,31.0,0.0,4.0,11.0,2.0,32.0,15.0,4.0,0.0,3.0,1.0,3.0,5.0,15.0,5.0,0.0,2.0,83.0,3.0,5.0,2.0,,6.0,1.0,3.0,2.0,4.0,11.0,0.0,3.0,5.0,14.0,3.0,9.0,81.0,1.0,1.0,15.0,3.0,1.0,2.0,43.0,0.0,17.0,1.0,4.0,10.0,2.0,20.0,0.0,0.0,1.0,4.0,13.0,1.0,0.0,20.0,0.0,2.0,5.0,4.0,0.0,9.0,4.0,2.0,2.0,1.0,76.0,5.0,0.0,0.0,10.0,0.0,0.0,129.0,0.0,1.0,4.0,435.0,23.0,0.0,2.0,0.0,,2.0,6.0,0.0,0.0,2.0,0.0,1.0,87.0,1.0,3.0,14.0,7.0,267.0,4.0,11.0,4.0,0.0,134.0,3.0,0.0,0.0,33.0,217.0,,189.0,4.0,0.0,0.0,0.0,0.0,1.0,0.0,1.0,12.0,5.0,0.0,6.0,0.0,2.0,1.0,0.0
2025-04-10 00:00:00+00:00,76.0,166.0,29.0,18.0,56.0,308.0,7.0,26.0,10.0,2.0,18.0,1.0,4.0,16.0,4.0,13.0,14.0,8.0,4.0,1.0,0.0,3.0,5.0,8.0,4.0,2.0,2.0,92.0,5.0,4.0,0.0,,3.0,3.0,1.0,2.0,3.0,10.0,0.0,1.0,3.0,16.0,2.0,2.0,76.0,3.0,0.0,19.0,2.0,0.0,1.0,75.0,0.0,23.0,1.0,11.0,5.0,1.0,15.0,0.0,0.0,0.0,5.0,6.0,0.0,3.0,21.0,1.0,2.0,6.0,8.0,0.0,15.0,1.0,0.0,2.0,2.0,50.0,2.0,0.0,0.0,11.0,0.0,0.0,131.0,0.0,3.0,7.0,426.0,15.0,0.0,2.0,0.0,,3.0,4.0,3.0,4.0,3.0,2.0,0.0,93.0,1.0,1.0,27.0,14.0,48.0,1.0,3.0,2.0,0.0,85.0,2.0,0.0,0.0,27.0,175.0,,117.0,4.0,1.0,3.0,0.0,0.0,1.0,0.0,0.0,3.0,2.0,0.0,1.0,3.0,1.0,0.0,0.0
2025-04-11 00:00:00+00:00,120.0,166.0,43.0,34.0,72.0,351.0,6.0,26.0,10.0,7.0,29.0,4.0,14.0,8.0,6.0,11.0,22.0,7.0,9.0,2.0,0.0,2.0,6.0,7.0,6.0,2.0,1.0,106.0,5.0,2.0,0.0,,8.0,1.0,9.0,31.0,5.0,9.0,1.0,1.0,3.0,20.0,1.0,2.0,82.0,1.0,1.0,22.0,3.0,0.0,2.0,63.0,0.0,26.0,0.0,9.0,5.0,0.0,29.0,0.0,0.0,0.0,0.0,6.0,0.0,0.0,22.0,0.0,1.0,5.0,7.0,0.0,16.0,0.0,0.0,2.0,1.0,61.0,0.0,3.0,0.0,4.0,0.0,0.0,109.0,0.0,4.0,6.0,404.0,18.0,0.0,0.0,1.0,,0.0,1.0,1.0,2.0,3.0,0.0,1.0,56.0,2.0,0.0,14.0,6.0,42.0,4.0,2.0,6.0,2.0,88.0,4.0,0.0,0.0,20.0,181.0,,117.0,2.0,1.0,1.0,0.0,0.0,1.0,3.0,0.0,3.0,5.0,0.0,6.0,2.0,5.0,0.0,0.0
2025-04-12 00:00:00+00:00,85.0,138.0,33.0,12.0,55.0,280.0,4.0,37.0,14.0,0.0,34.0,0.0,2.0,5.0,0.0,16.0,15.0,6.0,0.0,1.0,0.0,2.0,1.0,9.0,2.0,0.0,4.0,81.0,5.0,2.0,1.0,,6.0,2.0,4.0,21.0,3.0,11.0,3.0,4.0,3.0,20.0,2.0,3.0,67.0,1.0,0.0,12.0,1.0,0.0,5.0,65.0,0.0,10.0,0.0,6.0,1.0,0.0,12.0,1.0,1.0,0.0,1.0,4.0,0.0,0.0,14.0,0.0,1.0,7.0,6.0,0.0,15.0,1.0,0.0,0.0,1.0,76.0,1.0,1.0,0.0,0.0,0.0,0.0,115.0,0.0,3.0,6.0,328.0,7.0,0.0,0.0,0.0,,0.0,2.0,0.0,1.0,2.0,0.0,0.0,60.0,0.0,0.0,11.0,3.0,39.0,1.0,3.0,4.0,0.0,67.0,2.0,0.0,0.0,19.0,138.0,,89.0,2.0,0.0,0.0,0.0,0.0,0.0,0.0,0.0,3.0,1.0,0.0,4.0,0.0,0.0,0.0,0.0
2025-04-13 00:00:00+00:00,85.0,119.0,31.0,16.0,57.0,302.0,9.0,31.0,8.0,1.0,26.0,0.0,1.0,1.0,4.0,21.0,12.0,3.0,0.0,1.0,0.0,4.0,1.0,7.0,0.0,0.0,1.0,103.0,3.0,1.0,3.0,,2.0,0.0,0.0,2.0,2.0,29.0,0.0,2.0,4.0,13.0,3.0,1.0,39.0,1.0,1.0,15.0,1.0,1.0,4.0,34.0,0.0,9.0,2.0,11.0,1.0,0.0,23.0,1.0,1.0,0.0,3.0,4.0,2.0,0.0,17.0,0.0,1.0,3.0,3.0,0.0,13.0,0.0,1.0,1.0,0.0,52.0,2.0,0.0,1.0,0.0,0.0,0.0,97.0,0.0,0.0,9.0,358.0,4.0,0.0,1.0,3.0,,0.0,0.0,0.0,0.0,1.0,2.0,3.0,71.0,2.0,0.0,12.0,5.0,23.0,1.0,0.0,2.0,0.0,58.0,3.0,0.0,0.0,20.0,119.0,,90.0,0.0,0.0,0.0,0.0,0.0,0.0,1.0,0.0,1.0,3.0,0.0,1.0,0.0,0.0,1.0,0.0
2025-04-14 00:00:00+00:00,123.0,144.0,39.0,13.0,61.0,310.0,5.0,29.0,7.0,3.0,57.0,2.0,2.0,5.0,4.0,21.0,15.0,4.0,3.0,2.0,0.0,2.0,3.0,11.0,4.0,1.0,3.0,88.0,4.0,0.0,0.0,,5.0,2.0,3.0,6.0,4.0,31.0,0.0,1.0,3.0,25.0,2.0,3.0,62.0,2.0,2.0,11.0,3.0,2.0,0.0,50.0,0.0,19.0,1.0,8.0,4.0,1.0,23.0,0.0,0.0,2.0,3.0,1.0,0.0,0.0,19.0,0.0,2.0,5.0,4.0,0.0,9.0,1.0,0.0,5.0,0.0,50.0,0.0,0.0,0.0,5.0,0.0,0.0,80.0,0.0,0.0,5.0,460.0,7.0,0.0,2.0,0.0,,0.0,6.0,1.0,4.0,3.0,1.0,1.0,74.0,0.0,0.0,9.0,11.0,36.0,5.0,3.0,7.0,1.0,72.0,5.0,0.0,1.0,53.0,145.0,,102.0,7.0,2.0,1.0,0.0,0.0,1.0,0.0,0.0,5.0,12.0,0.0,10.0,1.0,2.0,2.0,0.0
2025-04-15 00:00:00+00:00,56.0,131.0,26.0,15.0,25.0,267.0,14.0,33.0,18.0,3.0,83.0,0.0,4.0,2.0,3.0,17.0,11.0,3.0,1.0,0.0,0.0,0.0,4.0,17.0,3.0,0.0,4.0,97.0,17.0,0.0,1.0,72.0,30.0,2.0,1.0,31.0,3.0,5.0,3.0,2.0,6.0,9.0,3.0,3.0,38.0,1.0,0.0,22.0,2.0,1.0,0.0,40.0,0.0,8.0,2.0,4.0,2.0,1.0,17.0,1.0,0.0,1.0,0.0,9.0,0.0,5.0,19.0,0.0,1.0,7.0,3.0,0.0,16.0,0.0,1.0,3.0,1.0,57.0,0.0,4.0,0.0,1.0,0.0,0.0,56.0,0.0,1.0,4.0,405.0,12.0,0.0,2.0,0.0,,1.0,5.0,6.0,1.0,1.0,3.0,1.0,37.0,1.0,2.0,11.0,8.0,24.0,2.0,3.0,3.0,0.0,48.0,1.0,0.0,1.0,33.0,148.0,1.0,77.0,2.0,0.0,0.0,0.0,0.0,0.0,0.0,1.0,0.0,3.0,0.0,4.0,0.0,1.0,3.0,0.0
2025-04-16 00:00:00+00:00,30.0,130.0,45.0,13.0,14.0,236.0,13.0,33.0,14.0,1.0,165.0,0.0,1.0,7.0,3.0,10.0,13.0,5.0,0.0,0.0,0.0,2.0,1.0,5.0,4.0,0.0,5.0,112.0,5.0,3.0,4.0,72.0,51.0,1.0,2.0,52.0,4.0,5.0,2.0,1.0,2.0,27.0,1.0,4.0,48.0,4.0,1.0,9.0,3.0,0.0,1.0,91.0,1.0,9.0,3.0,7.0,0.0,0.0,16.0,0.0,0.0,2.0,0.0,1.0,1.0,1.0,13.0,0.0,4.0,7.0,5.0,0.0,11.0,0.0,1.0,6.0,2.0,49.0,1.0,0.0,1.0,6.0,0.0,0.0,53.0,0.0,1.0,2.0,389.0,10.0,0.0,13.0,0.0,,1.0,5.0,5.0,0.0,0.0,2.0,4.0,38.0,0.0,0.0,40.0,6.0,24.0,4.0,2.0,1.0,0.0,58.0,2.0,1.0,1.0,30.0,141.0,0.0,90.0,6.0,0.0,0.0,0.0,0.0,1.0,0.0,0.0,4.0,4.0,0.0,2.0,3.0,0.0,2.0,0.0
2025-04-17 00:00:00+00:00,59.0,127.0,37.0,13.0,20.0,295.0,11.0,21.0,25.0,6.0,109.0,2.0,13.0,7.0,2.0,11.0,6.0,2.0,3.0,1.0,0.0,1.0,2.0,7.0,1.0,0.0,2.0,92.0,7.0,0.0,1.0,101.0,58.0,5.0,7.0,57.0,8.0,4.0,0.0,0.0,6.0,10.0,3.0,0.0,49.0,1.0,1.0,18.0,2.0,0.0,0.0,56.0,0.0,7.0,3.0,1.0,0.0,1.0,19.0,0.0,0.0,0.0,0.0,1.0,2.0,3.0,24.0,0.0,0.0,7.0,2.0,0.0,10.0,0.0,1.0,6.0,0.0,42.0,3.0,0.0,1.0,1.0,0.0,0.0,106.0,0.0,1.0,5.0,390.0,23.0,0.0,1.0,0.0,,1.0,0.0,7.0,1.0,2.0,1.0,1.0,35.0,0.0,0.0,27.0,7.0,33.0,0.0,2.0,2.0,1.0,54.0,1.0,0.0,1.0,38.0,143.0,0.0,83.0,4.0,0.0,0.0,0.0,0.0,0.0,1.0,1.0,1.0,7.0,0.0,1.0,0.0,4.0,0.0,0.0
2025-04-18 00:00:00+00:00,61.0,139.0,29.0,9.0,23.0,273.0,5.0,16.0,14.0,2.0,87.0,1.0,5.0,3.0,3.0,15.0,12.0,4.0,3.0,4.0,0.0,0.0,3.0,2.0,0.0,0.0,3.0,81.0,2.0,0.0,0.0,69.0,57.0,4.0,5.0,65.0,3.0,7.0,1.0,4.0,3.0,10.0,21.0,0.0,34.0,0.0,0.0,15.0,5.0,1.0,0.0,61.0,0.0,5.0,0.0,3.0,4.0,0.0,13.0,0.0,0.0,2.0,0.0,3.0,0.0,3.0,26.0,0.0,1.0,5.0,4.0,0.0,11.0,0.0,0.0,3.0,2.0,40.0,1.0,1.0,2.0,1.0,0.0,0.0,98.0,0.0,2.0,2.0,347.0,19.0,0.0,1.0,0.0,,0.0,0.0,17.0,3.0,1.0,0.0,1.0,37.0,2.0,0.0,20.0,5.0,20.0,1.0,2.0,0.0,1.0,54.0,6.0,0.0,1.0,18.0,122.0,1.0,86.0,7.0,0.0,0.0,0.0,0.0,0.0,1.0,0.0,7.0,1.0,0.0,0.0,0.0,1.0,3.0,0.0
2025-04-19 00:00:00+00:00,54.0,95.0,25.0,16.0,16.0,239.0,4.0,32.0,10.0,3.0,67.0,1.0,7.0,4.0,0.0,12.0,9.0,4.0,0.0,0.0,0.0,0.0,4.0,2.0,2.0,1.0,3.0,60.0,2.0,0.0,0.0,44.0,31.0,2.0,0.0,32.0,1.0,9.0,1.0,4.0,1.0,9.0,5.0,1.0,39.0,2.0,1.0,14.0,1.0,0.0,1.0,40.0,0.0,7.0,0.0,9.0,1.0,1.0,17.0,2.0,0.0,0.0,0.0,2.0,1.0,0.0,21.0,0.0,1.0,4.0,4.0,0.0,10.0,0.0,3.0,5.0,0.0,40.0,2.0,0.0,0.0,2.0,0.0,0.0,111.0,0.0,2.0,2.0,307.0,8.0,0.0,25.0,0.0,,1.0,1.0,9.0,1.0,0.0,1.0,5.0,41.0,1.0,0.0,9.0,5.0,23.0,2.0,0.0,4.0,0.0,48.0,1.0,0.0,1.0,19.0,97.0,1.0,69.0,1.0,0.0,0.0,0.0,0.0,1.0,2.0,0.0,1.0,0.0,0.0,4.0,0.0,0.0,1.0,0.0
2025-04-20 00:00:00+00:00,65.0,110.0,42.0,13.0,20.0,220.0,4.0,16.0,5.0,0.0,38.0,2.0,5.0,2.0,1.0,20.0,10.0,2.0,2.0,0.0,0.0,3.0,6.0,2.0,7.0,0.0,2.0,78.0,2.0,0.0,0.0,46.0,5.0,1.0,2.0,1.0,4.0,4.0,0.0,2.0,4.0,11.0,2.0,0.0,41.0,1.0,1.0,16.0,3.0,0.0,1.0,46.0,0.0,10.0,1.0,5.0,1.0,0.0,27.0,1.0,1.0,0.0,0.0,1.0,1.0,2.0,10.0,1.0,0.0,1.0,2.0,0.0,8.0,0.0,0.0,1.0,0.0,42.0,0.0,0.0,0.0,1.0,0.0,0.0,94.0,0.0,1.0,5.0,323.0,6.0,0.0,11.0,0.0,,0.0,0.0,10.0,0.0,1.0,2.0,1.0,30.0,4.0,0.0,13.0,23.0,16.0,4.0,0.0,0.0,0.0,44.0,0.0,0.0,1.0,32.0,106.0,3.0,63.0,7.0,0.0,0.0,0.0,0.0,1.0,0.0,0.0,0.0,3.0,0.0,1.0,0.0,0.0,5.0,0.0
2025-04-21 00:00:00+00:00,66.0,139.0,36.0,10.0,14.0,201.0,5.0,18.0,14.0,4.0,33.0,2.0,1.0,6.0,3.0,15.0,18.0,6.0,1.0,1.0,0.0,5.0,13.0,3.0,16.0,0.0,2.0,89.0,3.0,1.0,0.0,53.0,6.0,8.0,1.0,6.0,2.0,5.0,2.0,1.0,6.0,14.0,6.0,2.0,64.0,1.0,0.0,17.0,5.0,0.0,2.0,126.0,1.0,24.0,1.0,4.0,1.0,0.0,15.0,0.0,0.0,1.0,1.0,4.0,0.0,0.0,27.0,0.0,0.0,4.0,6.0,0.0,6.0,0.0,1.0,0.0,1.0,68.0,4.0,0.0,0.0,0.0,0.0,0.0,87.0,0.0,1.0,3.0,402.0,13.0,1.0,1.0,0.0,,1.0,0.0,2.0,1.0,2.0,1.0,1.0,33.0,0.0,0.0,10.0,8.0,30.0,0.0,1.0,1.0,0.0,56.0,6.0,0.0,0.0,18.0,163.0,1.0,70.0,5.0,0.0,0.0,0.0,0.0,0.0,0.0,0.0,0.0,4.0,0.0,4.0,0.0,0.0,3.0,0.0
2025-04-22 00:00:00+00:00,46.0,172.0,42.0,34.0,18.0,276.0,8.0,32.0,21.0,2.0,27.0,2.0,1.0,3.0,8.0,16.0,23.0,6.0,14.0,1.0,0.0,0.0,2.0,9.0,3.0,0.0,4.0,92.0,10.0,0.0,1.0,94.0,15.0,2.0,6.0,1.0,3.0,7.0,1.0,0.0,5.0,14.0,6.0,1.0,59.0,3.0,0.0,20.0,2.0,1.0,0.0,95.0,0.0,11.0,0.0,12.0,5.0,1.0,14.0,1.0,0.0,1.0,1.0,3.0,3.0,2.0,23.0,1.0,1.0,5.0,6.0,1.0,13.0,0.0,4.0,5.0,0.0,41.0,2.0,2.0,0.0,5.0,0.0,0.0,123.0,0.0,1.0,0.0,461.0,11.0,2.0,3.0,0.0,,0.0,1.0,1.0,1.0,4.0,0.0,4.0,48.0,0.0,1.0,18.0,9.0,23.0,2.0,1.0,4.0,0.0,55.0,3.0,0.0,1.0,25.0,155.0,16.0,76.0,2.0,0.0,1.0,0.0,0.0,1.0,0.0,1.0,1.0,18.0,0.0,3.0,2.0,1.0,1.0,0.0
2025-04-23 00:00:00+00:00,103.0,142.0,45.0,21.0,22.0,273.0,15.0,23.0,21.0,3.0,23.0,2.0,3.0,7.0,3.0,22.0,17.0,5.0,3.0,4.0,0.0,0.0,2.0,15.0,2.0,0.0,1.0,99.0,16.0,0.0,0.0,67.0,5.0,1.0,1.0,3.0,0.0,10.0,4.0,2.0,2.0,21.0,3.0,8.0,46.0,7.0,0.0,16.0,2.0,1.0,1.0,137.0,0.0,14.0,2.0,4.0,7.0,1.0,21.0,3.0,1.0,3.0,0.0,3.0,3.0,1.0,29.0,1.0,0.0,5.0,5.0,0.0,6.0,0.0,3.0,1.0,1.0,65.0,2.0,3.0,0.0,3.0,0.0,0.0,112.0,0.0,1.0,1.0,467.0,6.0,0.0,3.0,1.0,,0.0,3.0,3.0,0.0,9.0,7.0,2.0,73.0,1.0,1.0,9.0,8.0,28.0,2.0,4.0,5.0,0.0,54.0,1.0,0.0,0.0,19.0,144.0,5.0,95.0,4.0,0.0,0.0,0.0,0.0,1.0,1.0,0.0,4.0,10.0,0.0,3.0,0.0,5.0,1.0,0.0
2025-04-24 00:00:00+00:00,43.0,118.0,48.0,18.0,71.0,301.0,3.0,22.0,23.0,2.0,20.0,31.0,1.0,4.0,3.0,17.0,8.0,10.0,6.0,0.0,0.0,2.0,2.0,11.0,3.0,4.0,1.0,94.0,11.0,0.0,3.0,37.0,4.0,1.0,4.0,6.0,2.0,6.0,12.0,3.0,2.0,16.0,5.0,1.0,50.0,2.0,0.0,21.0,3.0,0.0,0.0,307.0,2.0,9.0,4.0,2.0,3.0,6.0,25.0,11.0,0.0,1.0,0.0,0.0,1.0,5.0,14.0,0.0,2.0,2.0,10.0,0.0,9.0,0.0,0.0,2.0,0.0,75.0,2.0,0.0,0.0,2.0,0.0,0.0,96.0,0.0,1.0,2.0,432.0,3.0,0.0,66.0,0.0,,1.0,3.0,1.0,2.0,1.0,1.0,0.0,53.0,1.0,0.0,21.0,11.0,28.0,3.0,0.0,2.0,1.0,53.0,3.0,8.0,0.0,24.0,143.0,24.0,72.0,0.0,1.0,0.0,0.0,0.0,0.0,1.0,1.0,1.0,8.0,0.0,8.0,0.0,3.0,18.0,0.0
2025-04-25 00:00:00+00:00,72.0,128.0,57.0,16.0,76.0,286.0,6.0,23.0,13.0,2.0,35.0,2.0,1.0,14.0,7.0,8.0,12.0,7.0,19.0,2.0,0.0,0.0,8.0,9.0,5.0,0.0,0.0,129.0,9.0,3.0,2.0,56.0,7.0,3.0,1.0,4.0,4.0,8.0,52.0,3.0,3.0,14.0,3.0,4.0,45.0,8.0,0.0,29.0,5.0,1.0,1.0,238.0,0.0,8.0,0.0,4.0,7.0,2.0,26.0,2.0,0.0,3.0,2.0,0.0,1.0,4.0,20.0,1.0,2.0,8.0,7.0,0.0,9.0,0.0,0.0,3.0,9.0,79.0,5.0,0.0,1.0,3.0,0.0,0.0,142.0,1.0,1.0,1.0,400.0,13.0,1.0,41.0,0.0,,1.0,3.0,0.0,0.0,11.0,2.0,1.0,46.0,1.0,0.0,14.0,8.0,32.0,1.0,1.0,0.0,0.0,48.0,11.0,0.0,0.0,27.0,169.0,15.0,86.0,0.0,7.0,1.0,0.0,0.0,0.0,1.0,1.0,0.0,4.0,0.0,10.0,1.0,1.0,3.0,0.0
2025-04-26 00:00:00+00:00,64.0,125.0,32.0,8.0,64.0,269.0,3.0,20.0,11.0,1.0,41.0,0.0,2.0,2.0,3.0,13.0,4.0,7.0,7.0,0.0,0.0,0.0,2.0,5.0,5.0,0.0,1.0,80.0,5.0,0.0,13.0,27.0,4.0,2.0,0.0,1.0,0.0,11.0,41.0,0.0,3.0,10.0,2.0,0.0,35.0,0.0,0.0,16.0,3.0,0.0,0.0,266.0,0.0,10.0,1.0,1.0,6.0,0.0,12.0,3.0,1.0,0.0,4.0,1.0,1.0,2.0,32.0,0.0,2.0,1.0,7.0,0.0,5.0,1.0,0.0,1.0,4.0,36.0,1.0,0.0,0.0,1.0,0.0,0.0,77.0,0.0,1.0,3.0,357.0,6.0,0.0,70.0,0.0,,0.0,0.0,1.0,2.0,17.0,0.0,1.0,42.0,1.0,0.0,9.0,8.0,24.0,2.0,1.0,0.0,0.0,43.0,1.0,0.0,0.0,23.0,133.0,5.0,88.0,0.0,2.0,0.0,0.0,0.0,0.0,0.0,0.0,0.0,0.0,0.0,6.0,0.0,0.0,2.0,0.0
2025-04-27 00:00:00+00:00,41.0,116.0,41.0,9.0,24.0,279.0,5.0,18.0,5.0,1.0,23.0,1.0,4.0,1.0,4.0,10.0,5.0,5.0,1.0,31.0,0.0,2.0,2.0,5.0,6.0,0.0,1.0,58.0,5.0,0.0,4.0,39.0,3.0,7.0,3.0,1.0,1.0,9.0,0.0,0.0,7.0,9.0,2.0,0.0,42.0,1.0,1.0,12.0,1.0,0.0,0.0,101.0,0.0,3.0,3.0,1.0,0.0,0.0,14.0,0.0,0.0,1.0,0.0,3.0,0.0,2.0,15.0,0.0,0.0,1.0,5.0,0.0,12.0,0.0,0.0,7.0,1.0,84.0,2.0,0.0,0.0,0.0,0.0,0.0,91.0,0.0,3.0,2.0,349.0,6.0,0.0,47.0,0.0,,0.0,1.0,0.0,2.0,15.0,0.0,0.0,45.0,1.0,0.0,7.0,6.0,27.0,2.0,1.0,2.0,1.0,44.0,3.0,0.0,0.0,16.0,114.0,1.0,68.0,1.0,0.0,0.0,0.0,0.0,1.0,1.0,0.0,2.0,2.0,0.0,8.0,0.0,0.0,0.0,0.0
2025-04-28 00:00:00+00:00,73.0,182.0,44.0,19.0,18.0,304.0,16.0,43.0,9.0,1.0,18.0,0.0,7.0,3.0,3.0,15.0,8.0,9.0,6.0,31.0,0.0,2.0,1.0,6.0,2.0,2.0,5.0,98.0,7.0,1.0,1.0,57.0,3.0,4.0,0.0,5.0,3.0,6.0,8.0,2.0,4.0,14.0,1.0,2.0,50.0,3.0,0.0,32.0,3.0,1.0,1.0,68.0,0.0,10.0,4.0,1.0,10.0,2.0,25.0,0.0,0.0,2.0,0.0,1.0,0.0,0.0,25.0,0.0,1.0,3.0,9.0,1.0,10.0,0.0,4.0,5.0,9.0,62.0,2.0,0.0,6.0,2.0,0.0,0.0,89.0,0.0,2.0,5.0,432.0,9.0,0.0,19.0,2.0,,0.0,0.0,0.0,0.0,23.0,1.0,3.0,47.0,1.0,0.0,9.0,6.0,36.0,0.0,1.0,3.0,0.0,78.0,4.0,0.0,0.0,27.0,169.0,1.0,108.0,1.0,1.0,2.0,0.0,1.0,0.0,2.0,0.0,6.0,10.0,3.0,8.0,0.0,1.0,1.0,0.0
2025-04-29 00:00:00+00:00,51.0,159.0,34.0,13.0,18.0,290.0,9.0,41.0,7.0,2.0,27.0,1.0,6.0,1.0,5.0,20.0,16.0,7.0,7.0,6.0,1.0,3.0,28.0,38.0,2.0,4.0,3.0,114.0,38.0,2.0,3.0,65.0,8.0,5.0,1.0,3.0,1.0,10.0,8.0,6.0,3.0,16.0,2.0,5.0,38.0,2.0,3.0,13.0,3.0,2.0,4.0,54.0,0.0,9.0,3.0,4.0,3.0,0.0,22.0,3.0,1.0,2.0,6.0,1.0,1.0,4.0,29.0,11.0,0.0,3.0,7.0,0.0,9.0,1.0,2.0,2.0,6.0,43.0,2.0,0.0,2.0,0.0,0.0,0.0,97.0,0.0,6.0,6.0,405.0,8.0,0.0,31.0,0.0,,0.0,4.0,1.0,0.0,15.0,0.0,1.0,52.0,3.0,0.0,8.0,10.0,37.0,7.0,9.0,1.0,0.0,66.0,5.0,0.0,1.0,32.0,155.0,1.0,116.0,0.0,0.0,1.0,0.0,0.0,0.0,2.0,1.0,22.0,10.0,1.0,11.0,0.0,2.0,2.0,0.0
2025-04-30 00:00:00+00:00,71.0,119.0,36.0,12.0,16.0,276.0,11.0,28.0,7.0,1.0,45.0,1.0,4.0,6.0,4.0,20.0,6.0,9.0,3.0,4.0,0.0,4.0,8.0,30.0,6.0,3.0,6.0,100.0,30.0,1.0,0.0,49.0,4.0,4.0,3.0,4.0,5.0,5.0,1.0,3.0,3.0,6.0,5.0,0.0,60.0,2.0,0.0,25.0,4.0,2.0,1.0,51.0,0.0,15.0,1.0,3.0,2.0,1.0,23.0,1.0,1.0,0.0,1.0,3.0,2.0,0.0,20.0,0.0,0.0,3.0,9.0,0.0,11.0,0.0,1.0,7.0,2.0,73.0,3.0,0.0,0.0,1.0,0.0,0.0,134.0,0.0,2.0,3.0,427.0,6.0,0.0,93.0,0.0,,0.0,2.0,1.0,2.0,12.0,1.0,1.0,52.0,1.0,1.0,9.0,8.0,40.0,8.0,1.0,2.0,0.0,82.0,4.0,0.0,0.0,25.0,181.0,6.0,104.0,1.0,0.0,0.0,0.0,0.0,0.0,0.0,0.0,2.0,22.0,0.0,6.0,0.0,1.0,0.0,0.0
2025-05-01 00:00:00+00:00,70.0,174.0,32.0,19.0,16.0,265.0,12.0,28.0,16.0,1.0,26.0,2.0,1.0,4.0,7.0,26.0,14.0,5.0,7.0,2.0,0.0,3.0,3.0,17.0,6.0,2.0,3.0,128.0,17.0,1.0,1.0,67.0,3.0,3.0,2.0,3.0,2.0,4.0,4.0,2.0,4.0,25.0,12.0,3.0,55.0,0.0,0.0,23.0,2.0,0.0,2.0,59.0,0.0,6.0,9.0,5.0,2.0,0.0,39.0,0.0,0.0,1.0,0.0,6.0,1.0,1.0,18.0,0.0,1.0,2.0,5.0,1.0,15.0,1.0,3.0,3.0,6.0,68.0,0.0,1.0,0.0,4.0,0.0,0.0,61.0,0.0,0.0,1.0,490.0,7.0,0.0,40.0,0.0,,0.0,0.0,0.0,1.0,19.0,0.0,27.0,42.0,1.0,0.0,22.0,13.0,19.0,2.0,1.0,2.0,0.0,57.0,4.0,9.0,0.0,24.0,149.0,5.0,97.0,0.0,0.0,1.0,0.0,0.0,0.0,0.0,0.0,6.0,25.0,0.0,6.0,0.0,0.0,8.0,0.0
2025-05-02 00:00:00+00:00,51.0,178.0,33.0,8.0,20.0,308.0,103.0,35.0,22.0,0.0,17.0,0.0,2.0,4.0,4.0,14.0,9.0,5.0,6.0,2.0,0.0,0.0,5.0,28.0,16.0,2.0,1.0,83.0,28.0,2.0,0.0,62.0,12.0,3.0,2.0,2.0,1.0,9.0,0.0,2.0,5.0,15.0,3.0,1.0,61.0,1.0,1.0,19.0,2.0,0.0,1.0,69.0,0.0,15.0,3.0,6.0,1.0,0.0,24.0,0.0,0.0,1.0,4.0,5.0,0.0,0.0,25.0,0.0,0.0,1.0,5.0,2.0,8.0,1.0,1.0,0.0,4.0,57.0,3.0,1.0,1.0,0.0,0.0,0.0,92.0,0.0,0.0,4.0,435.0,23.0,0.0,12.0,0.0,,0.0,0.0,4.0,2.0,7.0,2.0,12.0,45.0,0.0,1.0,18.0,9.0,27.0,1.0,0.0,3.0,0.0,64.0,0.0,3.0,1.0,35.0,169.0,5.0,100.0,2.0,0.0,0.0,0.0,0.0,0.0,4.0,0.0,2.0,11.0,4.0,8.0,1.0,1.0,1.0,0.0
2025-05-03 00:00:00+00:00,41.0,132.0,27.0,11.0,16.0,268.0,210.0,19.0,5.0,1.0,33.0,1.0,1.0,3.0,0.0,11.0,9.0,3.0,2.0,0.0,0.0,2.0,1.0,10.0,4.0,3.0,3.0,68.0,10.0,1.0,0.0,51.0,1.0,2.0,2.0,2.0,2.0,9.0,1.0,5.0,3.0,14.0,10.0,1.0,37.0,1.0,0.0,19.0,3.0,0.0,1.0,49.0,0.0,12.0,1.0,6.0,2.0,0.0,19.0,1.0,0.0,0.0,2.0,0.0,0.0,2.0,16.0,0.0,0.0,4.0,3.0,1.0,9.0,0.0,1.0,1.0,10.0,54.0,0.0,0.0,1.0,6.0,0.0,0.0,77.0,0.0,2.0,1.0,344.0,7.0,0.0,5.0,0.0,,0.0,3.0,2.0,0.0,13.0,3.0,3.0,44.0,8.0,0.0,14.0,10.0,37.0,3.0,1.0,2.0,0.0,68.0,2.0,0.0,0.0,23.0,111.0,1.0,87.0,0.0,1.0,2.0,0.0,0.0,2.0,2.0,0.0,0.0,6.0,2.0,6.0,0.0,0.0,2.0,0.0
2025-05-04 00:00:00+00:00,38.0,114.0,23.0,2.0,17.0,351.0,38.0,14.0,14.0,1.0,18.0,9.0,1.0,7.0,1.0,12.0,13.0,3.0,2.0,0.0,0.0,1.0,1.0,28.0,1.0,1.0,1.0,89.0,31.0,0.0,1.0,47.0,2.0,1.0,1.0,1.0,1.0,9.0,1.0,0.0,2.0,15.0,10.0,4.0,43.0,1.0,0.0,28.0,0.0,0.0,0.0,58.0,0.0,11.0,2.0,7.0,3.0,0.0,21.0,0.0,0.0,1.0,3.0,0.0,2.0,2.0,11.0,0.0,0.0,6.0,3.0,0.0,9.0,0.0,0.0,6.0,0.0,50.0,1.0,1.0,0.0,1.0,0.0,0.0,74.0,0.0,0.0,1.0,343.0,5.0,0.0,4.0,0.0,,0.0,1.0,1.0,0.0,10.0,1.0,0.0,50.0,2.0,0.0,10.0,9.0,54.0,1.0,1.0,0.0,0.0,66.0,2.0,2.0,2.0,44.0,138.0,0.0,92.0,0.0,0.0,0.0,0.0,0.0,0.0,0.0,0.0,1.0,3.0,0.0,4.0,0.0,2.0,0.0,0.0
2025-05-05 00:00:00+00:00,71.0,152.0,39.0,14.0,25.0,301.0,6.0,18.0,11.0,1.0,21.0,2.0,1.0,4.0,6.0,17.0,14.0,6.0,4.0,1.0,0.0,1.0,0.0,14.0,2.0,1.0,3.0,126.0,14.0,0.0,0.0,59.0,5.0,3.0,3.0,5.0,4.0,5.0,2.0,12.0,14.0,15.0,8.0,1.0,31.0,1.0,1.0,33.0,2.0,0.0,1.0,72.0,0.0,14.0,3.0,2.0,2.0,1.0,15.0,1.0,0.0,0.0,1.0,1.0,2.0,0.0,13.0,2.0,0.0,7.0,6.0,0.0,10.0,0.0,0.0,2.0,1.0,63.0,1.0,1.0,0.0,4.0,0.0,0.0,65.0,0.0,6.0,4.0,400.0,9.0,0.0,7.0,0.0,,1.0,4.0,4.0,0.0,8.0,0.0,2.0,47.0,3.0,0.0,15.0,6.0,132.0,1.0,2.0,3.0,0.0,63.0,1.0,0.0,8.0,21.0,148.0,0.0,92.0,1.0,0.0,0.0,3.0,0.0,0.0,0.0,0.0,1.0,15.0,8.0,9.0,1.0,1.0,2.0,0.0
2025-05-06 00:00:00+00:00,77.0,134.0,37.0,14.0,16.0,299.0,3.0,22.0,15.0,2.0,23.0,14.0,11.0,6.0,3.0,9.0,6.0,3.0,8.0,0.0,0.0,2.0,6.0,7.0,6.0,2.0,1.0,144.0,7.0,0.0,1.0,66.0,7.0,3.0,2.0,0.0,4.0,12.0,0.0,11.0,6.0,21.0,16.0,1.0,48.0,5.0,1.0,19.0,2.0,1.0,1.0,55.0,0.0,13.0,0.0,15.0,2.0,0.0,17.0,0.0,2.0,2.0,1.0,4.0,0.0,0.0,20.0,3.0,2.0,5.0,3.0,1.0,17.0,0.0,2.0,0.0,1.0,82.0,2.0,0.0,1.0,6.0,0.0,0.0,149.0,0.0,1.0,2.0,432.0,13.0,0.0,12.0,0.0,,0.0,2.0,1.0,0.0,10.0,0.0,0.0,45.0,1.0,0.0,17.0,3.0,53.0,4.0,2.0,2.0,0.0,73.0,3.0,0.0,3.0,37.0,183.0,0.0,89.0,0.0,0.0,3.0,0.0,1.0,0.0,1.0,0.0,0.0,14.0,3.0,5.0,0.0,2.0,0.0,0.0
2025-05-07 00:00:00+00:00,74.0,165.0,36.0,10.0,18.0,323.0,2.0,23.0,14.0,3.0,18.0,1.0,4.0,6.0,3.0,11.0,4.0,4.0,8.0,1.0,0.0,1.0,4.0,15.0,6.0,0.0,1.0,134.0,16.0,0.0,1.0,46.0,6.0,2.0,4.0,2.0,3.0,9.0,1.0,2.0,3.0,15.0,6.0,2.0,52.0,2.0,1.0,29.0,0.0,0.0,0.0,59.0,0.0,11.0,0.0,4.0,7.0,0.0,16.0,0.0,1.0,1.0,2.0,1.0,0.0,2.0,18.0,0.0,2.0,5.0,4.0,0.0,22.0,0.0,2.0,3.0,2.0,82.0,3.0,0.0,2.0,3.0,0.0,0.0,65.0,0.0,2.0,4.0,470.0,13.0,1.0,17.0,0.0,,0.0,1.0,4.0,0.0,4.0,0.0,0.0,78.0,0.0,0.0,16.0,13.0,45.0,1.0,3.0,7.0,0.0,82.0,20.0,0.0,0.0,21.0,166.0,0.0,94.0,1.0,0.0,2.0,0.0,1.0,0.0,0.0,1.0,3.0,9.0,0.0,9.0,0.0,1.0,2.0,0.0
2025-05-08 00:00:00+00:00,133.0,166.0,51.0,18.0,31.0,308.0,14.0,16.0,10.0,0.0,25.0,1.0,8.0,5.0,3.0,12.0,13.0,3.0,2.0,1.0,0.0,0.0,3.0,9.0,0.0,2.0,3.0,121.0,9.0,0.0,0.0,88.0,1.0,3.0,1.0,1.0,2.0,13.0,2.0,10.0,2.0,20.0,2.0,7.0,54.0,0.0,2.0,23.0,5.0,0.0,4.0,66.0,0.0,13.0,0.0,1.0,5.0,3.0,20.0,1.0,2.0,3.0,4.0,3.0,2.0,0.0,30.0,0.0,1.0,5.0,3.0,1.0,16.0,0.0,2.0,2.0,10.0,64.0,2.0,0.0,1.0,4.0,0.0,0.0,111.0,0.0,0.0,3.0,527.0,20.0,0.0,28.0,1.0,,0.0,0.0,1.0,2.0,1.0,0.0,1.0,63.0,0.0,1.0,20.0,7.0,42.0,3.0,1.0,5.0,0.0,100.0,3.0,1.0,0.0,31.0,197.0,0.0,100.0,0.0,0.0,5.0,0.0,0.0,0.0,0.0,0.0,3.0,7.0,0.0,9.0,0.0,4.0,0.0,0.0
2025-05-09 00:00:00+00:00,110.0,230.0,64.0,18.0,24.0,363.0,19.0,16.0,10.0,6.0,18.0,3.0,18.0,1.0,4.0,17.0,14.0,8.0,6.0,1.0,0.0,2.0,3.0,4.0,1.0,1.0,2.0,108.0,4.0,1.0,0.0,88.0,5.0,3.0,3.0,2.0,7.0,12.0,1.0,1.0,6.0,14.0,7.0,5.0,51.0,3.0,0.0,22.0,6.0,0.0,0.0,101.0,0.0,9.0,0.0,4.0,4.0,0.0,38.0,1.0,0.0,1.0,4.0,1.0,0.0,0.0,16.0,0.0,0.0,5.0,8.0,0.0,10.0,2.0,3.0,2.0,0.0,45.0,0.0,0.0,1.0,12.0,0.0,0.0,80.0,0.0,1.0,9.0,447.0,10.0,1.0,22.0,0.0,,1.0,2.0,1.0,3.0,1.0,0.0,4.0,52.0,2.0,1.0,14.0,10.0,26.0,3.0,1.0,3.0,1.0,61.0,9.0,0.0,0.0,20.0,182.0,2.0,106.0,0.0,1.0,0.0,0.0,0.0,0.0,0.0,1.0,2.0,4.0,1.0,8.0,1.0,0.0,1.0,0.0
2025-05-10 00:00:00+00:00,80.0,279.0,41.0,19.0,46.0,311.0,10.0,18.0,13.0,9.0,28.0,4.0,32.0,1.0,2.0,18.0,12.0,1.0,6.0,0.0,0.0,1.0,1.0,4.0,2.0,1.0,2.0,73.0,4.0,0.0,0.0,62.0,4.0,1.0,1.0,3.0,2.0,3.0,2.0,10.0,6.0,11.0,2.0,8.0,51.0,3.0,0.0,11.0,8.0,0.0,0.0,64.0,0.0,12.0,2.0,6.0,4.0,1.0,20.0,1.0,4.0,2.0,8.0,0.0,1.0,1.0,10.0,1.0,1.0,5.0,1.0,0.0,8.0,0.0,1.0,1.0,2.0,52.0,1.0,0.0,0.0,2.0,0.0,0.0,66.0,0.0,3.0,4.0,461.0,12.0,0.0,3.0,3.0,,3.0,0.0,0.0,0.0,1.0,0.0,0.0,53.0,1.0,0.0,6.0,7.0,34.0,1.0,0.0,2.0,0.0,57.0,1.0,0.0,0.0,47.0,179.0,0.0,92.0,0.0,1.0,1.0,0.0,0.0,0.0,2.0,0.0,1.0,0.0,1.0,2.0,0.0,1.0,0.0,0.0
2025-05-11 00:00:00+00:00,65.0,278.0,42.0,23.0,43.0,298.0,6.0,24.0,13.0,15.0,27.0,0.0,3.0,0.0,1.0,11.0,7.0,5.0,2.0,0.0,0.0,0.0,0.0,7.0,4.0,1.0,2.0,57.0,7.0,0.0,1.0,51.0,2.0,0.0,5.0,0.0,5.0,11.0,1.0,3.0,4.0,13.0,2.0,2.0,43.0,3.0,0.0,7.0,4.0,0.0,1.0,41.0,0.0,6.0,0.0,0.0,2.0,0.0,16.0,0.0,4.0,1.0,2.0,2.0,1.0,2.0,12.0,0.0,0.0,3.0,5.0,0.0,16.0,0.0,1.0,0.0,3.0,62.0,0.0,0.0,0.0,4.0,0.0,0.0,69.0,0.0,11.0,3.0,429.0,17.0,1.0,2.0,0.0,,0.0,1.0,5.0,2.0,4.0,0.0,1.0,54.0,0.0,0.0,12.0,5.0,35.0,2.0,0.0,5.0,0.0,55.0,2.0,0.0,0.0,24.0,156.0,0.0,90.0,0.0,0.0,1.0,0.0,0.0,0.0,0.0,0.0,2.0,1.0,1.0,6.0,0.0,1.0,4.0,0.0
2025-05-12 00:00:00+00:00,98.0,191.0,70.0,23.0,30.0,329.0,9.0,28.0,15.0,11.0,43.0,3.0,1.0,7.0,4.0,29.0,11.0,10.0,4.0,0.0,0.0,1.0,5.0,10.0,2.0,0.0,1.0,80.0,10.0,1.0,0.0,79.0,5.0,4.0,2.0,1.0,4.0,13.0,1.0,6.0,5.0,21.0,4.0,4.0,67.0,0.0,0.0,20.0,0.0,0.0,0.0,76.0,1.0,10.0,1.0,0.0,5.0,3.0,16.0,0.0,33.0,5.0,1.0,1.0,0.0,0.0,19.0,3.0,0.0,3.0,10.0,1.0,16.0,1.0,1.0,1.0,1.0,82.0,2.0,0.0,3.0,5.0,0.0,0.0,88.0,0.0,3.0,3.0,476.0,11.0,3.0,4.0,2.0,,0.0,2.0,1.0,4.0,2.0,4.0,2.0,50.0,0.0,0.0,10.0,8.0,41.0,0.0,1.0,0.0,2.0,53.0,2.0,0.0,2.0,79.0,160.0,1.0,103.0,3.0,0.0,2.0,0.0,1.0,0.0,1.0,1.0,6.0,4.0,0.0,9.0,0.0,0.0,3.0,0.0
2025-05-13 00:00:00+00:00,104.0,191.0,73.0,26.0,38.0,327.0,13.0,24.0,16.0,5.0,30.0,2.0,4.0,7.0,4.0,30.0,11.0,10.0,1.0,3.0,0.0,2.0,5.0,7.0,1.0,1.0,2.0,103.0,7.0,3.0,2.0,71.0,8.0,6.0,7.0,1.0,2.0,8.0,5.0,4.0,6.0,25.0,2.0,2.0,47.0,2.0,2.0,25.0,4.0,3.0,0.0,58.0,1.0,7.0,2.0,3.0,7.0,4.0,35.0,1.0,5.0,3.0,8.0,2.0,2.0,0.0,26.0,0.0,0.0,3.0,10.0,0.0,9.0,0.0,3.0,5.0,4.0,70.0,0.0,0.0,1.0,1.0,0.0,0.0,71.0,0.0,2.0,0.0,526.0,9.0,1.0,16.0,1.0,,0.0,6.0,1.0,1.0,3.0,2.0,0.0,50.0,2.0,2.0,17.0,5.0,37.0,7.0,2.0,1.0,3.0,78.0,3.0,0.0,0.0,52.0,205.0,0.0,111.0,3.0,0.0,2.0,0.0,0.0,1.0,0.0,0.0,2.0,5.0,0.0,33.0,2.0,3.0,1.0,1.0
2025-05-14 00:00:00+00:00,211.0,196.0,55.0,12.0,133.0,308.0,24.0,42.0,25.0,4.0,42.0,1.0,8.0,9.0,3.0,7.0,9.0,4.0,4.0,2.0,0.0,2.0,1.0,7.0,0.0,7.0,2.0,121.0,7.0,1.0,0.0,83.0,6.0,2.0,2.0,1.0,2.0,10.0,1.0,7.0,4.0,21.0,1.0,4.0,58.0,1.0,1.0,14.0,4.0,3.0,1.0,73.0,0.0,11.0,1.0,1.0,6.0,9.0,24.0,3.0,3.0,5.0,0.0,2.0,1.0,2.0,27.0,0.0,1.0,7.0,4.0,2.0,14.0,0.0,2.0,3.0,3.0,58.0,4.0,0.0,1.0,10.0,0.0,0.0,104.0,0.0,1.0,18.0,415.0,15.0,0.0,3.0,4.0,,0.0,1.0,2.0,2.0,2.0,1.0,7.0,58.0,0.0,2.0,15.0,11.0,40.0,2.0,0.0,4.0,1.0,60.0,4.0,0.0,0.0,26.0,183.0,2.0,92.0,1.0,2.0,0.0,1.0,1.0,1.0,0.0,0.0,0.0,8.0,11.0,27.0,0.0,0.0,0.0,1.0
2025-05-15 00:00:00+00:00,179.0,173.0,46.0,10.0,77.0,296.0,8.0,35.0,15.0,2.0,32.0,1.0,5.0,7.0,5.0,14.0,8.0,7.0,7.0,1.0,1.0,1.0,1.0,39.0,1.0,0.0,9.0,82.0,39.0,0.0,0.0,79.0,2.0,2.0,2.0,0.0,8.0,16.0,3.0,1.0,3.0,20.0,3.0,2.0,58.0,4.0,0.0,29.0,1.0,0.0,1.0,74.0,0.0,12.0,3.0,0.0,4.0,2.0,32.0,0.0,1.0,2.0,0.0,3.0,0.0,1.0,22.0,0.0,0.0,3.0,7.0,1.0,12.0,0.0,4.0,5.0,2.0,48.0,3.0,0.0,1.0,4.0,0.0,0.0,95.0,0.0,4.0,4.0,455.0,12.0,0.0,2.0,1.0,,1.0,2.0,1.0,2.0,3.0,1.0,0.0,57.0,2.0,2.0,17.0,12.0,28.0,9.0,1.0,3.0,3.0,74.0,3.0,0.0,2.0,20.0,189.0,1.0,101.0,2.0,1.0,1.0,0.0,0.0,0.0,0.0,3.0,1.0,9.0,9.0,14.0,0.0,2.0,0.0,0.0
2025-05-16 00:00:00+00:00,161.0,220.0,29.0,28.0,64.0,339.0,5.0,34.0,10.0,9.0,27.0,0.0,6.0,7.0,2.0,9.0,10.0,4.0,4.0,2.0,0.0,2.0,5.0,10.0,1.0,2.0,2.0,101.0,10.0,1.0,3.0,66.0,6.0,5.0,7.0,0.0,9.0,8.0,3.0,3.0,7.0,14.0,5.0,2.0,48.0,1.0,0.0,28.0,2.0,0.0,1.0,62.0,0.0,12.0,1.0,3.0,3.0,4.0,26.0,0.0,1.0,4.0,0.0,1.0,1.0,4.0,18.0,4.0,1.0,5.0,4.0,0.0,16.0,0.0,2.0,3.0,6.0,57.0,0.0,1.0,4.0,10.0,0.0,0.0,91.0,0.0,2.0,7.0,469.0,12.0,0.0,1.0,1.0,,0.0,2.0,1.0,0.0,4.0,1.0,10.0,41.0,0.0,1.0,16.0,15.0,40.0,7.0,1.0,1.0,2.0,58.0,1.0,0.0,0.0,22.0,158.0,2.0,95.0,1.0,0.0,0.0,0.0,0.0,0.0,1.0,0.0,2.0,0.0,6.0,7.0,0.0,2.0,0.0,2.0
2025-05-17 00:00:00+00:00,115.0,145.0,24.0,8.0,33.0,251.0,5.0,17.0,16.0,5.0,32.0,3.0,11.0,1.0,1.0,10.0,3.0,2.0,2.0,0.0,0.0,0.0,1.0,12.0,4.0,0.0,0.0,47.0,14.0,1.0,1.0,70.0,2.0,3.0,1.0,1.0,7.0,7.0,0.0,1.0,1.0,7.0,2.0,1.0,48.0,1.0,1.0,13.0,3.0,0.0,0.0,46.0,0.0,14.0,1.0,1.0,0.0,2.0,21.0,1.0,3.0,1.0,0.0,4.0,0.0,2.0,17.0,3.0,0.0,5.0,2.0,0.0,7.0,0.0,1.0,6.0,0.0,63.0,1.0,0.0,4.0,2.0,0.0,0.0,64.0,0.0,1.0,4.0,320.0,9.0,0.0,31.0,0.0,,0.0,0.0,1.0,0.0,2.0,0.0,8.0,27.0,2.0,0.0,9.0,4.0,23.0,1.0,3.0,0.0,1.0,37.0,4.0,0.0,0.0,11.0,134.0,0.0,74.0,0.0,0.0,1.0,0.0,0.0,0.0,1.0,0.0,0.0,0.0,0.0,8.0,1.0,0.0,0.0,0.0
2025-05-18 00:00:00+00:00,113.0,163.0,34.0,14.0,45.0,300.0,8.0,17.0,20.0,5.0,48.0,0.0,18.0,12.0,1.0,19.0,12.0,10.0,7.0,1.0,0.0,4.0,5.0,26.0,0.0,1.0,1.0,69.0,26.0,0.0,0.0,62.0,6.0,3.0,9.0,2.0,11.0,4.0,0.0,19.0,0.0,18.0,2.0,0.0,38.0,11.0,0.0,12.0,8.0,0.0,2.0,49.0,0.0,10.0,0.0,3.0,2.0,11.0,16.0,2.0,11.0,5.0,2.0,1.0,3.0,0.0,11.0,5.0,2.0,3.0,10.0,0.0,10.0,0.0,0.0,0.0,6.0,70.0,1.0,0.0,1.0,2.0,0.0,0.0,73.0,0.0,2.0,2.0,374.0,13.0,0.0,6.0,1.0,,0.0,1.0,2.0,0.0,0.0,0.0,2.0,45.0,3.0,1.0,6.0,4.0,18.0,1.0,13.0,3.0,2.0,57.0,5.0,0.0,0.0,21.0,152.0,0.0,74.0,0.0,0.0,1.0,0.0,0.0,0.0,0.0,0.0,1.0,4.0,0.0,12.0,0.0,1.0,1.0,1.0
2025-05-19 00:00:00+00:00,149.0,160.0,38.0,19.0,42.0,379.0,6.0,27.0,9.0,5.0,41.0,1.0,38.0,8.0,3.0,13.0,9.0,8.0,7.0,1.0,0.0,5.0,4.0,17.0,3.0,0.0,3.0,114.0,17.0,2.0,0.0,53.0,9.0,3.0,4.0,1.0,11.0,4.0,0.0,1.0,1.0,21.0,3.0,1.0,75.0,2.0,1.0,26.0,4.0,0.0,2.0,59.0,0.0,13.0,1.0,2.0,6.0,10.0,38.0,1.0,2.0,2.0,7.0,3.0,0.0,1.0,26.0,7.0,0.0,1.0,8.0,0.0,13.0,1.0,2.0,0.0,4.0,79.0,1.0,1.0,0.0,6.0,0.0,0.0,101.0,0.0,3.0,3.0,428.0,9.0,0.0,2.0,0.0,,2.0,2.0,1.0,0.0,1.0,1.0,0.0,47.0,0.0,0.0,15.0,7.0,43.0,4.0,8.0,6.0,1.0,58.0,1.0,0.0,0.0,20.0,173.0,0.0,103.0,0.0,0.0,1.0,0.0,0.0,2.0,0.0,4.0,3.0,3.0,0.0,3.0,1.0,0.0,0.0,0.0
2025-05-20 00:00:00+00:00,149.0,188.0,59.0,94.0,13.0,393.0,5.0,26.0,22.0,5.0,42.0,2.0,37.0,20.0,10.0,9.0,20.0,9.0,4.0,3.0,0.0,2.0,2.0,57.0,4.0,1.0,8.0,101.0,58.0,1.0,0.0,73.0,5.0,0.0,1.0,1.0,4.0,10.0,2.0,2.0,1.0,13.0,4.0,1.0,57.0,0.0,1.0,35.0,16.0,1.0,0.0,87.0,0.0,2.0,2.0,3.0,7.0,10.0,24.0,0.0,3.0,2.0,25.0,2.0,1.0,0.0,18.0,4.0,1.0,7.0,9.0,0.0,21.0,0.0,1.0,0.0,3.0,83.0,0.0,0.0,0.0,3.0,0.0,0.0,96.0,0.0,2.0,6.0,473.0,15.0,0.0,3.0,0.0,,1.0,1.0,3.0,2.0,3.0,3.0,1.0,52.0,1.0,0.0,19.0,8.0,37.0,3.0,5.0,5.0,1.0,73.0,4.0,0.0,1.0,29.0,175.0,0.0,99.0,0.0,0.0,0.0,0.0,1.0,1.0,0.0,2.0,1.0,5.0,0.0,8.0,0.0,0.0,2.0,2.0
2025-05-21 00:00:00+00:00,166.0,262.0,51.0,37.0,26.0,379.0,27.0,32.0,6.0,3.0,21.0,1.0,19.0,13.0,5.0,24.0,11.0,7.0,7.0,3.0,0.0,1.0,3.0,10.0,3.0,1.0,5.0,99.0,10.0,3.0,0.0,71.0,7.0,2.0,0.0,3.0,4.0,12.0,2.0,5.0,0.0,11.0,14.0,9.0,63.0,3.0,0.0,35.0,1.0,1.0,0.0,63.0,0.0,6.0,0.0,4.0,6.0,3.0,17.0,2.0,0.0,1.0,7.0,3.0,2.0,3.0,28.0,2.0,3.0,14.0,7.0,0.0,15.0,2.0,1.0,4.0,2.0,76.0,6.0,0.0,0.0,19.0,0.0,0.0,108.0,0.0,0.0,4.0,498.0,9.0,0.0,2.0,0.0,,0.0,3.0,3.0,0.0,2.0,2.0,5.0,61.0,3.0,2.0,25.0,15.0,56.0,0.0,1.0,3.0,0.0,78.0,5.0,0.0,0.0,38.0,207.0,0.0,117.0,0.0,0.0,2.0,0.0,0.0,1.0,1.0,0.0,0.0,8.0,1.0,11.0,0.0,0.0,0.0,1.0
2025-05-22 00:00:00+00:00,187.0,320.0,45.0,36.0,35.0,369.0,10.0,41.0,23.0,8.0,22.0,1.0,27.0,10.0,9.0,35.0,12.0,35.0,2.0,1.0,0.0,0.0,6.0,13.0,6.0,0.0,6.0,144.0,13.0,4.0,2.0,79.0,3.0,3.0,2.0,1.0,3.0,12.0,215.0,5.0,3.0,27.0,17.0,5.0,37.0,3.0,1.0,29.0,1.0,1.0,3.0,110.0,0.0,10.0,0.0,1.0,4.0,1.0,36.0,0.0,0.0,2.0,2.0,5.0,0.0,0.0,33.0,3.0,0.0,9.0,35.0,0.0,4.0,2.0,4.0,3.0,1.0,64.0,1.0,3.0,1.0,38.0,0.0,0.0,104.0,0.0,1.0,5.0,485.0,14.0,1.0,0.0,2.0,,2.0,2.0,1.0,1.0,2.0,0.0,1.0,79.0,0.0,1.0,17.0,10.0,33.0,1.0,2.0,4.0,1.0,81.0,3.0,0.0,1.0,76.0,176.0,0.0,106.0,0.0,1.0,0.0,0.0,0.0,1.0,1.0,0.0,1.0,4.0,0.0,9.0,0.0,5.0,2.0,0.0
2025-05-23 00:00:00+00:00,143.0,337.0,61.0,35.0,26.0,395.0,7.0,16.0,30.0,1.0,27.0,1.0,18.0,3.0,2.0,20.0,5.0,14.0,2.0,3.0,0.0,1.0,5.0,23.0,1.0,0.0,6.0,98.0,23.0,2.0,0.0,58.0,6.0,5.0,2.0,0.0,7.0,4.0,93.0,3.0,0.0,20.0,7.0,5.0,52.0,2.0,1.0,22.0,3.0,1.0,1.0,71.0,0.0,11.0,0.0,1.0,5.0,3.0,36.0,0.0,1.0,2.0,2.0,3.0,1.0,0.0,16.0,10.0,0.0,2.0,14.0,0.0,13.0,1.0,0.0,4.0,1.0,68.0,0.0,1.0,0.0,32.0,0.0,0.0,89.0,0.0,1.0,2.0,510.0,10.0,0.0,0.0,2.0,,0.0,3.0,2.0,0.0,2.0,0.0,3.0,61.0,1.0,0.0,20.0,12.0,37.0,1.0,1.0,2.0,0.0,75.0,6.0,0.0,0.0,41.0,188.0,0.0,126.0,1.0,0.0,0.0,1.0,0.0,3.0,1.0,0.0,1.0,3.0,0.0,11.0,1.0,0.0,2.0,0.0
2025-05-24 00:00:00+00:00,81.0,215.0,35.0,31.0,16.0,293.0,7.0,24.0,12.0,2.0,17.0,1.0,5.0,4.0,1.0,4.0,8.0,9.0,1.0,0.0,0.0,1.0,5.0,4.0,1.0,1.0,6.0,88.0,4.0,0.0,1.0,57.0,1.0,2.0,0.0,3.0,6.0,8.0,28.0,15.0,0.0,17.0,34.0,4.0,56.0,0.0,0.0,21.0,0.0,0.0,1.0,63.0,0.0,6.0,0.0,2.0,0.0,0.0,17.0,0.0,0.0,1.0,0.0,1.0,0.0,1.0,28.0,2.0,1.0,8.0,9.0,0.0,12.0,0.0,1.0,2.0,2.0,49.0,0.0,0.0,1.0,4.0,0.0,0.0,66.0,0.0,1.0,2.0,323.0,11.0,0.0,3.0,0.0,,0.0,0.0,0.0,0.0,3.0,0.0,1.0,38.0,0.0,1.0,9.0,14.0,35.0,2.0,4.0,0.0,0.0,45.0,2.0,5.0,0.0,60.0,132.0,0.0,88.0,0.0,0.0,1.0,0.0,0.0,0.0,0.0,0.0,1.0,0.0,0.0,6.0,0.0,0.0,1.0,0.0
2025-05-25 00:00:00+00:00,98.0,243.0,36.0,36.0,21.0,290.0,7.0,19.0,22.0,2.0,27.0,0.0,8.0,2.0,0.0,8.0,7.0,6.0,2.0,0.0,0.0,3.0,0.0,1.0,2.0,1.0,5.0,77.0,1.0,0.0,1.0,40.0,0.0,1.0,1.0,0.0,5.0,1.0,27.0,17.0,3.0,12.0,23.0,0.0,39.0,1.0,0.0,15.0,3.0,1.0,0.0,33.0,0.0,6.0,0.0,10.0,0.0,0.0,32.0,0.0,0.0,1.0,1.0,1.0,0.0,0.0,16.0,0.0,0.0,1.0,6.0,0.0,9.0,1.0,3.0,1.0,2.0,78.0,0.0,1.0,0.0,4.0,0.0,0.0,88.0,0.0,4.0,3.0,336.0,20.0,0.0,2.0,0.0,,0.0,0.0,1.0,1.0,0.0,1.0,4.0,51.0,0.0,0.0,11.0,12.0,27.0,0.0,1.0,0.0,0.0,42.0,3.0,3.0,0.0,227.0,133.0,0.0,79.0,2.0,0.0,1.0,0.0,0.0,0.0,2.0,0.0,1.0,2.0,0.0,22.0,0.0,0.0,0.0,1.0
2025-05-26 00:00:00+00:00,91.0,413.0,35.0,22.0,32.0,308.0,8.0,34.0,27.0,1.0,24.0,0.0,5.0,4.0,4.0,10.0,8.0,8.0,1.0,3.0,0.0,3.0,2.0,14.0,0.0,0.0,4.0,97.0,14.0,3.0,0.0,36.0,1.0,5.0,0.0,0.0,2.0,11.0,33.0,14.0,0.0,17.0,24.0,3.0,47.0,0.0,0.0,18.0,1.0,0.0,2.0,32.0,0.0,7.0,1.0,9.0,2.0,2.0,44.0,2.0,1.0,1.0,2.0,2.0,0.0,0.0,11.0,0.0,0.0,4.0,8.0,0.0,10.0,1.0,2.0,1.0,1.0,60.0,0.0,1.0,0.0,7.0,0.0,0.0,118.0,0.0,1.0,13.0,392.0,15.0,0.0,7.0,0.0,,0.0,1.0,0.0,0.0,3.0,1.0,2.0,60.0,0.0,0.0,10.0,11.0,45.0,3.0,2.0,3.0,0.0,51.0,4.0,3.0,0.0,248.0,157.0,1.0,104.0,1.0,0.0,1.0,0.0,0.0,0.0,0.0,3.0,1.0,2.0,0.0,6.0,0.0,2.0,2.0,1.0
2025-05-27 00:00:00+00:00,109.0,252.0,36.0,31.0,19.0,317.0,12.0,36.0,19.0,1.0,12.0,1.0,6.0,9.0,5.0,11.0,16.0,16.0,2.0,1.0,0.0,8.0,2.0,20.0,2.0,1.0,1.0,74.0,21.0,2.0,0.0,61.0,6.0,1.0,0.0,5.0,9.0,8.0,38.0,3.0,1.0,26.0,29.0,2.0,62.0,39.0,2.0,24.0,0.0,2.0,3.0,29.0,0.0,6.0,2.0,47.0,1.0,2.0,38.0,0.0,2.0,2.0,1.0,0.0,1.0,2.0,29.0,1.0,2.0,1.0,16.0,0.0,15.0,0.0,3.0,1.0,0.0,73.0,3.0,1.0,2.0,3.0,0.0,0.0,89.0,0.0,1.0,10.0,438.0,15.0,3.0,9.0,0.0,,3.0,3.0,6.0,2.0,1.0,4.0,3.0,52.0,2.0,0.0,12.0,11.0,38.0,3.0,1.0,0.0,0.0,58.0,9.0,0.0,0.0,111.0,167.0,1.0,106.0,0.0,1.0,1.0,10.0,1.0,0.0,0.0,1.0,3.0,6.0,1.0,6.0,0.0,1.0,0.0,1.0
2025-05-28 00:00:00+00:00,123.0,294.0,54.0,30.0,16.0,337.0,4.0,16.0,31.0,6.0,14.0,0.0,1.0,7.0,2.0,19.0,15.0,10.0,7.0,2.0,0.0,1.0,2.0,14.0,1.0,1.0,4.0,92.0,14.0,0.0,3.0,41.0,6.0,2.0,1.0,1.0,4.0,9.0,61.0,7.0,0.0,25.0,26.0,2.0,58.0,8.0,0.0,27.0,4.0,1.0,2.0,33.0,0.0,9.0,4.0,36.0,4.0,7.0,28.0,1.0,0.0,3.0,0.0,3.0,1.0,0.0,17.0,2.0,0.0,3.0,10.0,0.0,13.0,1.0,1.0,2.0,0.0,75.0,1.0,0.0,0.0,4.0,0.0,0.0,74.0,0.0,2.0,8.0,447.0,11.0,0.0,1.0,0.0,,0.0,3.0,2.0,1.0,6.0,2.0,2.0,68.0,1.0,1.0,18.0,7.0,43.0,3.0,1.0,7.0,0.0,49.0,5.0,0.0,4.0,38.0,205.0,0.0,106.0,0.0,0.0,2.0,10.0,0.0,0.0,0.0,1.0,0.0,21.0,0.0,21.0,1.0,1.0,4.0,1.0
2025-05-29 00:00:00+00:00,152.0,255.0,65.0,30.0,25.0,372.0,5.0,22.0,12.0,3.0,20.0,4.0,22.0,7.0,3.0,7.0,8.0,8.0,5.0,0.0,0.0,1.0,9.0,12.0,4.0,1.0,2.0,95.0,12.0,3.0,0.0,57.0,3.0,6.0,1.0,5.0,17.0,6.0,20.0,13.0,5.0,17.0,59.0,2.0,52.0,2.0,0.0,25.0,2.0,1.0,1.0,39.0,1.0,12.0,3.0,29.0,3.0,6.0,19.0,0.0,1.0,1.0,5.0,8.0,0.0,0.0,15.0,1.0,1.0,4.0,8.0,0.0,16.0,1.0,1.0,2.0,4.0,69.0,0.0,0.0,0.0,2.0,0.0,0.0,73.0,0.0,3.0,7.0,432.0,12.0,0.0,2.0,0.0,,0.0,1.0,3.0,0.0,2.0,0.0,4.0,46.0,0.0,0.0,10.0,14.0,39.0,3.0,4.0,2.0,2.0,60.0,1.0,0.0,2.0,26.0,189.0,0.0,93.0,4.0,0.0,2.0,0.0,1.0,0.0,1.0,3.0,1.0,4.0,0.0,14.0,1.0,0.0,0.0,2.0
2025-05-30 00:00:00+00:00,97.0,284.0,28.0,26.0,21.0,328.0,12.0,16.0,5.0,8.0,20.0,9.0,4.0,6.0,3.0,16.0,8.0,6.0,4.0,1.0,0.0,4.0,5.0,7.0,2.0,3.0,1.0,76.0,7.0,2.0,0.0,60.0,6.0,1.0,0.0,1.0,3.0,8.0,28.0,3.0,2.0,15.0,39.0,3.0,55.0,5.0,1.0,24.0,3.0,1.0,1.0,28.0,0.0,2.0,2.0,26.0,6.0,0.0,16.0,8.0,0.0,1.0,4.0,3.0,0.0,1.0,17.0,2.0,0.0,5.0,6.0,0.0,8.0,1.0,3.0,0.0,0.0,49.0,1.0,1.0,0.0,0.0,0.0,0.0,83.0,0.0,1.0,3.0,417.0,11.0,0.0,1.0,0.0,,1.0,0.0,4.0,0.0,3.0,1.0,7.0,40.0,0.0,2.0,13.0,9.0,35.0,6.0,1.0,2.0,0.0,65.0,1.0,1.0,0.0,32.0,183.0,0.0,103.0,3.0,2.0,0.0,0.0,1.0,0.0,1.0,2.0,2.0,3.0,0.0,21.0,0.0,0.0,2.0,1.0
2025-05-31 00:00:00+00:00,75.0,193.0,40.0,7.0,14.0,308.0,14.0,23.0,8.0,2.0,9.0,4.0,12.0,4.0,1.0,7.0,17.0,8.0,1.0,0.0,0.0,2.0,4.0,8.0,3.0,0.0,0.0,72.0,8.0,0.0,1.0,45.0,3.0,3.0,0.0,0.0,7.0,8.0,17.0,3.0,1.0,15.0,20.0,0.0,47.0,0.0,1.0,17.0,3.0,0.0,0.0,55.0,0.0,11.0,5.0,20.0,0.0,0.0,24.0,1.0,0.0,3.0,2.0,0.0,0.0,0.0,14.0,0.0,1.0,10.0,8.0,0.0,11.0,0.0,1.0,1.0,0.0,53.0,0.0,0.0,0.0,2.0,0.0,0.0,107.0,0.0,0.0,2.0,377.0,7.0,0.0,0.0,0.0,,0.0,3.0,1.0,2.0,1.0,0.0,4.0,35.0,0.0,0.0,8.0,5.0,19.0,1.0,3.0,0.0,0.0,59.0,0.0,0.0,0.0,38.0,134.0,3.0,85.0,1.0,2.0,0.0,3.0,0.0,0.0,0.0,0.0,0.0,1.0,0.0,9.0,0.0,0.0,2.0,2.0
2025-06-01 00:00:00+00:00,64.0,172.0,38.0,8.0,8.0,300.0,18.0,22.0,4.0,2.0,10.0,3.0,4.0,2.0,0.0,21.0,8.0,3.0,2.0,1.0,0.0,3.0,3.0,2.0,7.0,0.0,1.0,81.0,2.0,2.0,1.0,37.0,5.0,1.0,1.0,2.0,3.0,5.0,11.0,4.0,1.0,10.0,27.0,0.0,35.0,1.0,0.0,27.0,1.0,1.0,0.0,29.0,0.0,11.0,2.0,15.0,0.0,2.0,20.0,1.0,0.0,5.0,1.0,0.0,0.0,0.0,20.0,0.0,0.0,6.0,3.0,0.0,13.0,0.0,0.0,0.0,0.0,101.0,4.0,0.0,0.0,5.0,0.0,0.0,54.0,0.0,1.0,5.0,366.0,23.0,1.0,2.0,0.0,,0.0,0.0,3.0,2.0,0.0,0.0,3.0,42.0,1.0,0.0,6.0,10.0,30.0,0.0,1.0,1.0,0.0,34.0,3.0,0.0,0.0,25.0,137.0,0.0,77.0,1.0,1.0,3.0,1.0,0.0,0.0,0.0,0.0,0.0,1.0,0.0,9.0,0.0,0.0,0.0,0.0
2025-06-02 00:00:00+00:00,123.0,291.0,54.0,25.0,10.0,377.0,30.0,47.0,15.0,0.0,21.0,3.0,7.0,6.0,4.0,19.0,10.0,8.0,9.0,2.0,0.0,4.0,3.0,6.0,4.0,1.0,3.0,112.0,6.0,1.0,8.0,44.0,3.0,0.0,0.0,2.0,9.0,5.0,6.0,9.0,2.0,12.0,14.0,3.0,45.0,6.0,2.0,11.0,5.0,2.0,0.0,39.0,0.0,9.0,5.0,13.0,0.0,5.0,21.0,2.0,0.0,17.0,4.0,2.0,0.0,3.0,22.0,3.0,0.0,2.0,8.0,0.0,10.0,0.0,3.0,0.0,2.0,100.0,1.0,0.0,0.0,16.0,0.0,0.0,62.0,0.0,3.0,2.0,463.0,20.0,0.0,1.0,0.0,,0.0,0.0,2.0,10.0,1.0,2.0,2.0,49.0,0.0,2.0,18.0,18.0,32.0,5.0,2.0,3.0,0.0,64.0,4.0,0.0,1.0,34.0,168.0,2.0,102.0,4.0,1.0,0.0,1.0,1.0,1.0,0.0,0.0,2.0,1.0,1.0,16.0,0.0,1.0,2.0,2.0
2025-06-03 00:00:00+00:00,177.0,308.0,51.0,26.0,13.0,344.0,30.0,38.0,20.0,7.0,13.0,12.0,16.0,8.0,8.0,6.0,13.0,9.0,11.0,1.0,0.0,1.0,9.0,3.0,3.0,0.0,1.0,138.0,3.0,2.0,0.0,42.0,11.0,2.0,3.0,1.0,9.0,16.0,3.0,10.0,1.0,16.0,19.0,4.0,51.0,20.0,1.0,23.0,1.0,2.0,0.0,51.0,0.0,8.0,1.0,9.0,2.0,11.0,17.0,0.0,0.0,9.0,2.0,1.0,0.0,3.0,43.0,0.0,2.0,5.0,9.0,0.0,10.0,1.0,4.0,0.0,1.0,76.0,3.0,2.0,0.0,47.0,0.0,0.0,106.0,0.0,3.0,5.0,460.0,17.0,0.0,0.0,1.0,,0.0,4.0,4.0,14.0,3.0,1.0,2.0,45.0,1.0,2.0,14.0,13.0,44.0,2.0,2.0,3.0,0.0,56.0,4.0,1.0,4.0,40.0,155.0,2.0,86.0,10.0,0.0,0.0,1.0,1.0,0.0,1.0,1.0,2.0,8.0,1.0,10.0,0.0,0.0,1.0,0.0
2025-06-04 00:00:00+00:00,165.0,254.0,60.0,35.0,25.0,378.0,28.0,27.0,22.0,2.0,26.0,15.0,7.0,10.0,1.0,20.0,9.0,4.0,12.0,0.0,0.0,2.0,3.0,6.0,6.0,1.0,5.0,131.0,6.0,2.0,3.0,74.0,6.0,5.0,3.0,2.0,4.0,14.0,11.0,8.0,1.0,21.0,18.0,2.0,53.0,5.0,1.0,25.0,2.0,1.0,0.0,48.0,1.0,8.0,6.0,45.0,1.0,2.0,41.0,12.0,0.0,9.0,2.0,0.0,0.0,3.0,19.0,2.0,0.0,5.0,4.0,2.0,7.0,1.0,3.0,1.0,3.0,99.0,7.0,0.0,0.0,56.0,0.0,0.0,71.0,0.0,3.0,13.0,472.0,10.0,0.0,10.0,2.0,,0.0,2.0,0.0,1.0,3.0,1.0,3.0,48.0,0.0,0.0,20.0,16.0,40.0,1.0,1.0,3.0,0.0,68.0,4.0,0.0,0.0,49.0,189.0,0.0,98.0,3.0,0.0,3.0,1.0,0.0,0.0,0.0,0.0,4.0,13.0,0.0,11.0,0.0,1.0,0.0,2.0
2025-06-05 00:00:00+00:00,140.0,247.0,46.0,27.0,19.0,351.0,36.0,28.0,30.0,3.0,17.0,2.0,6.0,5.0,5.0,18.0,10.0,1.0,5.0,1.0,0.0,3.0,2.0,16.0,1.0,2.0,5.0,142.0,15.0,4.0,4.0,104.0,4.0,1.0,5.0,3.0,7.0,16.0,16.0,2.0,0.0,16.0,14.0,1.0,57.0,1.0,0.0,27.0,3.0,4.0,4.0,48.0,0.0,12.0,1.0,15.0,2.0,1.0,16.0,0.0,2.0,2.0,1.0,1.0,0.0,3.0,20.0,1.0,2.0,3.0,1.0,0.0,17.0,1.0,2.0,7.0,4.0,83.0,3.0,0.0,0.0,7.0,0.0,0.0,106.0,0.0,2.0,6.0,470.0,12.0,0.0,37.0,0.0,,0.0,1.0,2.0,2.0,6.0,0.0,4.0,45.0,0.0,0.0,30.0,13.0,39.0,2.0,2.0,4.0,0.0,83.0,3.0,0.0,1.0,53.0,189.0,0.0,100.0,1.0,7.0,0.0,0.0,0.0,1.0,1.0,1.0,6.0,5.0,1.0,17.0,1.0,22.0,1.0,0.0
2025-06-06 00:00:00+00:00,65.0,232.0,40.0,22.0,8.0,301.0,22.0,22.0,15.0,4.0,12.0,3.0,11.0,6.0,2.0,19.0,8.0,5.0,8.0,0.0,0.0,4.0,12.0,8.0,6.0,0.0,3.0,108.0,8.0,0.0,1.0,47.0,6.0,0.0,0.0,1.0,6.0,8.0,0.0,6.0,1.0,16.0,7.0,3.0,36.0,3.0,1.0,29.0,0.0,1.0,0.0,57.0,0.0,8.0,7.0,7.0,6.0,1.0,27.0,0.0,0.0,4.0,0.0,3.0,0.0,1.0,21.0,3.0,1.0,5.0,5.0,0.0,10.0,1.0,2.0,5.0,0.0,104.0,5.0,0.0,1.0,1.0,0.0,0.0,51.0,0.0,4.0,3.0,465.0,5.0,0.0,6.0,0.0,,1.0,0.0,1.0,1.0,4.0,1.0,2.0,67.0,1.0,0.0,12.0,14.0,38.0,3.0,5.0,2.0,0.0,51.0,1.0,0.0,1.0,27.0,210.0,0.0,98.0,1.0,0.0,1.0,0.0,0.0,0.0,0.0,0.0,4.0,8.0,0.0,15.0,0.0,0.0,4.0,0.0
2025-06-07 00:00:00+00:00,95.0,170.0,57.0,26.0,21.0,279.0,13.0,19.0,12.0,2.0,7.0,2.0,3.0,4.0,0.0,11.0,11.0,2.0,5.0,0.0,0.0,8.0,4.0,11.0,0.0,0.0,1.0,76.0,11.0,0.0,1.0,120.0,3.0,4.0,0.0,0.0,6.0,6.0,5.0,8.0,3.0,10.0,8.0,0.0,38.0,9.0,0.0,27.0,3.0,0.0,0.0,44.0,0.0,7.0,3.0,3.0,3.0,2.0,18.0,0.0,0.0,1.0,1.0,0.0,0.0,0.0,19.0,0.0,0.0,6.0,2.0,0.0,11.0,0.0,5.0,3.0,4.0,73.0,1.0,1.0,1.0,15.0,0.0,0.0,35.0,0.0,0.0,6.0,424.0,14.0,1.0,0.0,0.0,,1.0,1.0,0.0,1.0,0.0,1.0,2.0,36.0,0.0,0.0,6.0,6.0,29.0,2.0,1.0,1.0,0.0,27.0,0.0,0.0,1.0,20.0,133.0,1.0,69.0,2.0,0.0,2.0,0.0,0.0,1.0,0.0,0.0,2.0,0.0,0.0,5.0,0.0,2.0,0.0,1.0
2025-06-08 00:00:00+00:00,70.0,182.0,34.0,6.0,7.0,292.0,18.0,19.0,18.0,0.0,10.0,1.0,4.0,3.0,1.0,14.0,7.0,2.0,1.0,0.0,0.0,3.0,2.0,3.0,2.0,0.0,1.0,87.0,3.0,0.0,0.0,85.0,0.0,5.0,0.0,0.0,5.0,3.0,12.0,6.0,0.0,13.0,4.0,0.0,50.0,2.0,1.0,28.0,0.0,0.0,0.0,23.0,0.0,13.0,1.0,8.0,1.0,0.0,10.0,0.0,0.0,0.0,0.0,1.0,1.0,1.0,18.0,0.0,1.0,1.0,2.0,0.0,8.0,1.0,2.0,2.0,1.0,72.0,1.0,0.0,1.0,4.0,0.0,0.0,53.0,0.0,1.0,4.0,401.0,14.0,0.0,0.0,2.0,,0.0,1.0,1.0,1.0,0.0,2.0,0.0,36.0,1.0,0.0,13.0,16.0,31.0,3.0,1.0,0.0,0.0,37.0,1.0,0.0,0.0,33.0,116.0,0.0,80.0,1.0,1.0,3.0,0.0,0.0,0.0,0.0,0.0,1.0,3.0,0.0,2.0,0.0,0.0,1.0,0.0
2025-06-09 00:00:00+00:00,136.0,254.0,46.0,24.0,21.0,346.0,6.0,28.0,22.0,2.0,26.0,7.0,1.0,6.0,3.0,22.0,4.0,10.0,3.0,0.0,0.0,1.0,3.0,9.0,0.0,0.0,3.0,94.0,9.0,2.0,0.0,247.0,3.0,1.0,9.0,1.0,0.0,4.0,31.0,4.0,2.0,11.0,4.0,3.0,48.0,4.0,0.0,31.0,1.0,0.0,0.0,33.0,1.0,12.0,6.0,1.0,5.0,8.0,19.0,0.0,0.0,2.0,3.0,2.0,2.0,3.0,21.0,0.0,1.0,7.0,10.0,0.0,24.0,0.0,3.0,6.0,0.0,80.0,3.0,1.0,1.0,9.0,0.0,0.0,91.0,0.0,3.0,4.0,518.0,12.0,1.0,1.0,1.0,,1.0,0.0,4.0,1.0,1.0,0.0,3.0,54.0,0.0,1.0,14.0,7.0,27.0,1.0,2.0,0.0,0.0,65.0,3.0,0.0,0.0,32.0,157.0,0.0,105.0,0.0,1.0,1.0,0.0,0.0,0.0,0.0,0.0,2.0,7.0,0.0,11.0,0.0,0.0,0.0,0.0
2025-06-10 00:00:00+00:00,168.0,278.0,93.0,56.0,15.0,296.0,12.0,23.0,48.0,4.0,25.0,7.0,5.0,8.0,6.0,13.0,12.0,7.0,2.0,0.0,0.0,1.0,11.0,12.0,2.0,6.0,5.0,95.0,12.0,0.0,5.0,162.0,4.0,2.0,0.0,1.0,7.0,8.0,2.0,12.0,0.0,13.0,6.0,1.0,57.0,2.0,0.0,30.0,1.0,0.0,1.0,15.0,0.0,7.0,1.0,4.0,3.0,9.0,16.0,1.0,0.0,0.0,0.0,3.0,2.0,0.0,15.0,1.0,0.0,2.0,7.0,1.0,10.0,1.0,2.0,1.0,2.0,71.0,0.0,0.0,0.0,0.0,0.0,0.0,79.0,0.0,2.0,3.0,478.0,10.0,0.0,0.0,0.0,,3.0,3.0,6.0,0.0,4.0,0.0,3.0,36.0,1.0,1.0,32.0,18.0,29.0,1.0,4.0,2.0,0.0,38.0,3.0,0.0,0.0,29.0,159.0,1.0,90.0,0.0,0.0,0.0,1.0,0.0,0.0,3.0,0.0,2.0,18.0,0.0,19.0,0.0,3.0,3.0,2.0
2025-06-11 00:00:00+00:00,100.0,291.0,79.0,55.0,48.0,342.0,8.0,29.0,28.0,5.0,23.0,3.0,3.0,12.0,5.0,13.0,10.0,5.0,3.0,0.0,0.0,3.0,4.0,7.0,0.0,4.0,4.0,123.0,7.0,1.0,0.0,92.0,6.0,2.0,0.0,9.0,5.0,2.0,9.0,5.0,2.0,10.0,9.0,5.0,66.0,15.0,0.0,25.0,3.0,0.0,0.0,26.0,0.0,12.0,1.0,6.0,0.0,4.0,19.0,0.0,0.0,3.0,2.0,3.0,2.0,2.0,25.0,1.0,1.0,8.0,5.0,1.0,19.0,0.0,3.0,3.0,0.0,67.0,4.0,0.0,0.0,4.0,0.0,0.0,74.0,0.0,0.0,10.0,498.0,6.0,1.0,1.0,0.0,,0.0,1.0,1.0,0.0,2.0,0.0,2.0,51.0,0.0,1.0,26.0,18.0,33.0,3.0,1.0,3.0,1.0,57.0,1.0,0.0,2.0,26.0,159.0,0.0,102.0,0.0,0.0,1.0,0.0,0.0,0.0,0.0,0.0,5.0,10.0,0.0,125.0,0.0,9.0,1.0,1.0
2025-06-12 00:00:00+00:00,150.0,280.0,42.0,29.0,25.0,354.0,10.0,19.0,29.0,1.0,17.0,3.0,1.0,7.0,7.0,13.0,8.0,5.0,12.0,1.0,0.0,9.0,6.0,13.0,4.0,4.0,3.0,118.0,15.0,2.0,0.0,77.0,6.0,2.0,2.0,1.0,2.0,17.0,5.0,5.0,5.0,18.0,9.0,4.0,46.0,3.0,1.0,36.0,2.0,0.0,1.0,26.0,0.0,9.0,7.0,1.0,1.0,4.0,22.0,0.0,0.0,3.0,0.0,2.0,1.0,2.0,29.0,0.0,3.0,5.0,5.0,0.0,12.0,4.0,1.0,2.0,0.0,86.0,0.0,0.0,0.0,0.0,0.0,0.0,115.0,0.0,1.0,8.0,518.0,8.0,0.0,0.0,1.0,,0.0,0.0,2.0,1.0,1.0,1.0,6.0,53.0,2.0,0.0,13.0,7.0,34.0,4.0,1.0,3.0,0.0,72.0,5.0,0.0,0.0,34.0,189.0,1.0,104.0,2.0,1.0,2.0,0.0,1.0,1.0,0.0,0.0,3.0,6.0,0.0,72.0,0.0,2.0,0.0,3.0
2025-06-13 00:00:00+00:00,97.0,238.0,66.0,13.0,15.0,331.0,4.0,35.0,21.0,3.0,14.0,5.0,7.0,5.0,11.0,11.0,68.0,4.0,10.0,3.0,0.0,3.0,1.0,11.0,9.0,7.0,3.0,114.0,11.0,0.0,2.0,44.0,8.0,1.0,2.0,0.0,10.0,7.0,4.0,4.0,2.0,10.0,3.0,0.0,43.0,1.0,0.0,23.0,0.0,4.0,2.0,17.0,0.0,15.0,4.0,3.0,5.0,1.0,14.0,0.0,0.0,1.0,4.0,3.0,1.0,2.0,14.0,0.0,0.0,8.0,4.0,0.0,15.0,1.0,2.0,2.0,0.0,214.0,0.0,1.0,1.0,3.0,0.0,0.0,102.0,0.0,0.0,5.0,479.0,7.0,1.0,0.0,0.0,,0.0,3.0,1.0,1.0,4.0,0.0,3.0,40.0,2.0,3.0,15.0,10.0,23.0,4.0,2.0,2.0,0.0,77.0,2.0,0.0,0.0,35.0,185.0,0.0,93.0,0.0,1.0,1.0,0.0,0.0,1.0,0.0,0.0,0.0,2.0,0.0,19.0,1.0,1.0,2.0,1.0
2025-06-14 00:00:00+00:00,101.0,160.0,37.0,33.0,16.0,276.0,4.0,29.0,12.0,1.0,16.0,1.0,3.0,3.0,8.0,7.0,61.0,7.0,6.0,0.0,0.0,1.0,4.0,4.0,1.0,5.0,1.0,77.0,4.0,0.0,2.0,46.0,0.0,0.0,1.0,0.0,16.0,8.0,2.0,1.0,0.0,6.0,12.0,0.0,55.0,2.0,0.0,12.0,4.0,0.0,1.0,17.0,0.0,14.0,2.0,2.0,1.0,0.0,14.0,0.0,0.0,1.0,0.0,1.0,0.0,3.0,11.0,2.0,0.0,1.0,7.0,0.0,12.0,0.0,0.0,1.0,0.0,77.0,2.0,0.0,0.0,1.0,0.0,0.0,70.0,0.0,3.0,4.0,374.0,5.0,0.0,10.0,0.0,,0.0,0.0,0.0,1.0,0.0,0.0,3.0,39.0,0.0,0.0,9.0,7.0,18.0,0.0,1.0,0.0,0.0,55.0,2.0,0.0,1.0,34.0,150.0,0.0,86.0,1.0,0.0,0.0,0.0,0.0,0.0,0.0,0.0,1.0,1.0,0.0,20.0,0.0,2.0,1.0,1.0
2025-06-15 00:00:00+00:00,73.0,124.0,36.0,20.0,8.0,287.0,3.0,17.0,10.0,2.0,15.0,0.0,1.0,5.0,5.0,13.0,36.0,4.0,5.0,0.0,1.0,0.0,2.0,2.0,7.0,4.0,1.0,64.0,2.0,0.0,3.0,42.0,1.0,4.0,1.0,2.0,3.0,8.0,3.0,1.0,1.0,12.0,3.0,0.0,36.0,2.0,0.0,16.0,0.0,1.0,1.0,11.0,0.0,3.0,0.0,3.0,2.0,0.0,10.0,0.0,4.0,2.0,0.0,0.0,0.0,1.0,21.0,0.0,0.0,4.0,4.0,0.0,9.0,0.0,1.0,9.0,0.0,88.0,2.0,0.0,0.0,4.0,0.0,0.0,93.0,0.0,0.0,7.0,406.0,7.0,0.0,20.0,0.0,,0.0,1.0,1.0,1.0,3.0,0.0,0.0,36.0,1.0,0.0,8.0,10.0,34.0,2.0,2.0,1.0,0.0,53.0,3.0,0.0,0.0,25.0,138.0,0.0,85.0,2.0,0.0,1.0,0.0,1.0,0.0,0.0,0.0,0.0,4.0,0.0,17.0,0.0,0.0,0.0,0.0
2025-06-16 00:00:00+00:00,87.0,279.0,54.0,32.0,14.0,386.0,3.0,33.0,22.0,4.0,25.0,0.0,3.0,12.0,8.0,26.0,52.0,7.0,10.0,1.0,0.0,6.0,2.0,3.0,3.0,7.0,2.0,77.0,3.0,2.0,1.0,51.0,15.0,0.0,0.0,4.0,3.0,10.0,8.0,2.0,0.0,17.0,14.0,5.0,56.0,0.0,2.0,17.0,1.0,0.0,0.0,61.0,0.0,12.0,2.0,1.0,3.0,1.0,31.0,0.0,1.0,0.0,0.0,0.0,2.0,3.0,17.0,0.0,0.0,5.0,7.0,0.0,13.0,0.0,3.0,5.0,1.0,107.0,0.0,0.0,1.0,12.0,0.0,0.0,97.0,0.0,1.0,7.0,490.0,14.0,0.0,14.0,0.0,,1.0,1.0,1.0,0.0,1.0,0.0,3.0,52.0,0.0,2.0,17.0,10.0,37.0,1.0,1.0,0.0,0.0,84.0,2.0,0.0,0.0,34.0,169.0,0.0,95.0,0.0,0.0,0.0,0.0,1.0,0.0,0.0,0.0,6.0,4.0,0.0,40.0,0.0,1.0,2.0,1.0
2025-06-17 00:00:00+00:00,93.0,213.0,51.0,45.0,24.0,368.0,4.0,25.0,14.0,2.0,18.0,4.0,2.0,11.0,3.0,17.0,58.0,3.0,6.0,3.0,0.0,0.0,1.0,4.0,10.0,2.0,1.0,122.0,4.0,2.0,0.0,43.0,7.0,2.0,1.0,4.0,1.0,7.0,3.0,3.0,5.0,12.0,8.0,3.0,53.0,5.0,2.0,31.0,2.0,3.0,0.0,31.0,0.0,8.0,3.0,5.0,2.0,0.0,17.0,0.0,5.0,3.0,0.0,2.0,1.0,3.0,25.0,0.0,0.0,3.0,3.0,0.0,8.0,0.0,2.0,2.0,0.0,99.0,4.0,0.0,1.0,0.0,0.0,0.0,67.0,0.0,0.0,3.0,460.0,10.0,0.0,22.0,0.0,,2.0,0.0,0.0,0.0,3.0,0.0,3.0,44.0,2.0,0.0,18.0,12.0,37.0,2.0,1.0,2.0,0.0,68.0,0.0,0.0,1.0,37.0,182.0,0.0,121.0,1.0,0.0,1.0,0.0,0.0,0.0,0.0,0.0,7.0,4.0,0.0,36.0,0.0,0.0,0.0,0.0
2025-06-18 00:00:00+00:00,140.0,243.0,41.0,42.0,30.0,355.0,17.0,40.0,12.0,1.0,20.0,1.0,2.0,5.0,9.0,6.0,31.0,5.0,4.0,0.0,0.0,0.0,8.0,100.0,9.0,4.0,3.0,109.0,101.0,1.0,0.0,56.0,7.0,2.0,2.0,4.0,6.0,5.0,7.0,2.0,2.0,18.0,12.0,3.0,51.0,6.0,3.0,23.0,5.0,0.0,2.0,32.0,0.0,9.0,0.0,1.0,3.0,2.0,23.0,2.0,0.0,4.0,1.0,1.0,0.0,4.0,30.0,0.0,0.0,4.0,5.0,0.0,11.0,1.0,1.0,4.0,0.0,118.0,0.0,2.0,0.0,3.0,0.0,0.0,64.0,0.0,3.0,5.0,466.0,6.0,0.0,18.0,0.0,,1.0,2.0,1.0,0.0,1.0,0.0,4.0,58.0,4.0,0.0,24.0,12.0,42.0,4.0,0.0,8.0,1.0,85.0,2.0,0.0,0.0,38.0,144.0,1.0,111.0,1.0,0.0,0.0,0.0,1.0,0.0,3.0,0.0,0.0,5.0,0.0,17.0,0.0,0.0,1.0,0.0
2025-06-19 00:00:00+00:00,112.0,251.0,54.0,24.0,27.0,342.0,17.0,16.0,21.0,2.0,48.0,0.0,7.0,5.0,17.0,10.0,32.0,2.0,12.0,3.0,0.0,0.0,10.0,6.0,2.0,5.0,4.0,116.0,6.0,0.0,0.0,65.0,3.0,2.0,8.0,0.0,6.0,5.0,0.0,3.0,2.0,16.0,6.0,0.0,59.0,4.0,0.0,20.0,0.0,0.0,1.0,29.0,0.0,13.0,14.0,5.0,1.0,1.0,35.0,0.0,0.0,2.0,0.0,2.0,2.0,2.0,25.0,0.0,2.0,4.0,2.0,2.0,6.0,0.0,4.0,4.0,3.0,92.0,3.0,1.0,0.0,4.0,0.0,0.0,112.0,0.0,4.0,4.0,473.0,4.0,0.0,3.0,1.0,,0.0,0.0,1.0,0.0,2.0,0.0,2.0,50.0,1.0,2.0,9.0,8.0,30.0,4.0,5.0,4.0,2.0,58.0,2.0,0.0,0.0,27.0,176.0,0.0,96.0,0.0,0.0,1.0,0.0,0.0,0.0,0.0,0.0,0.0,4.0,0.0,14.0,0.0,1.0,1.0,1.0
2025-06-20 00:00:00+00:00,109.0,195.0,48.0,31.0,22.0,382.0,10.0,13.0,24.0,0.0,21.0,2.0,4.0,4.0,6.0,12.0,17.0,9.0,10.0,0.0,0.0,2.0,2.0,3.0,2.0,5.0,1.0,97.0,4.0,1.0,0.0,73.0,0.0,1.0,2.0,1.0,6.0,11.0,2.0,2.0,5.0,14.0,6.0,1.0,53.0,2.0,0.0,41.0,0.0,1.0,1.0,32.0,0.0,9.0,3.0,4.0,0.0,0.0,18.0,3.0,0.0,2.0,1.0,1.0,1.0,4.0,11.0,0.0,0.0,6.0,9.0,0.0,9.0,0.0,4.0,2.0,0.0,94.0,1.0,0.0,0.0,1.0,0.0,0.0,79.0,0.0,1.0,3.0,445.0,9.0,0.0,1.0,0.0,,0.0,2.0,0.0,0.0,4.0,0.0,1.0,46.0,0.0,0.0,13.0,4.0,30.0,4.0,1.0,3.0,2.0,64.0,0.0,0.0,2.0,58.0,172.0,0.0,121.0,0.0,0.0,1.0,0.0,0.0,0.0,1.0,0.0,3.0,4.0,0.0,18.0,0.0,1.0,0.0,0.0
